stock_name,date,value,count,Individual_buy_count,NonIndividual_buy_count,Individual_sell_count,NonIndividual_sell_count,Individual_buy_volume,NonIndividual_buy_volume,Individual_sell_volume,NonIndividual_sell_volume,Individual_buy_value,NonIndividual_buy_value,Individual_sell_value,NonIndividual_sell_value,adj_max_price,adj_min_price,adj_first_price,adj_last_price,adj_volume,adj_close_price,change
وصنعت,2008-11-26,454488337,71,16,3,8,2,702861,150010,302861,550010,374782947,79705390,161156400,293331937,34,33,34,34,852871,34,-1.46252285191956
وصنعت,2008-11-29,171912931,71,9,3,12,1,134595,194072,328657,10,70413185,101499746,171907611,5320,33,33,33,33,328667,33,-1.2987012987013
وصنعت,2008-11-30,35596786,15,6,3,6,1,53264,14212,67466,10,28140022,7456764,35591466,5320,33,32,33,33,67476,33,0
وصنعت,2008-12-01,55028297,26,9,3,3,1,56277,50010,106277,10,29162997,25865300,55022997,5300,33,32,33,33,106287,33,-0.37593984962406
وصنعت,2008-12-02,342348746,129,10,3,15,1,520957,143317,664264,10,268393485,73955261,342343576,5170,34,32,32,32,664274,32,-2.45283018867925
وصنعت,2008-12-03,78382935,24,3,3,7,1,50016,100028,150034,10,25678196,52704739,78377755,5180,33,32,32,32,150044,32,0.193423597678917
وصنعت,2008-12-07,103370224,40,8,1,4,0,185408,20000,205408,0,93310224,10060000,103370224,0,31,31,31,31,205408,32,-0.772200772200772
وصنعت,2008-12-08,3013805,3,3,0,2,0,5819,0,5819,0,3013805,0,3013805,0,33,31,31,33,5819,32,0
وصنعت,2008-12-10,33481000,15,6,0,4,0,67000,0,67000,0,33481000,0,33481000,0,31,31,31,31,67000,32,-0.194552529182879
وصنعت,2008-12-13,96700281,38,5,2,8,0,128528,63390,191918,0,64925281,31775000,96700281,0,32,31,31,32,191918,32,-0.389863547758285
وصنعت,2008-12-14,3134164,2,2,0,1,0,6194,0,6194,0,3134164,0,3134164,0,31,31,31,31,6194,32,0
وصنعت,2008-12-15,71739810,31,6,0,6,0,137300,0,137300,0,71739810,0,71739810,0,33,32,33,33,137300,32,0.391389432485323
وصنعت,2008-12-16,340159946,97,9,1,7,1,539308,104970,159817,484461,284735786,55424160,84366946,255793000,33,33,33,33,644278,33,2.53411306042885
وصنعت,2008-12-21,29979150,9,5,0,6,1,56350,0,50000,6350,29979150,0,26620000,3359150,35,31,33,31,56350,33,1.14068441064639
وصنعت,2008-12-22,71086460,29,12,1,6,0,126916,10000,136916,0,65916460,5170000,71086460,0,34,32,34,32,136916,33,-0.37593984962406
وصنعت,2008-12-23,37679460,10,6,0,2,1,72870,0,24250,48620,37679460,0,12542920,25136540,32,32,32,32,72870,33,-0.188679245283019
وصنعت,2008-12-24,198719505,44,11,0,3,1,384741,0,34741,350000,198719505,0,18348240,180371265,34,32,34,32,384741,33,-1.13421550094518
وصنعت,2008-12-27,53188884,20,9,1,6,0,72800,30000,102800,0,37738884,15450000,53188884,0,33,32,32,32,102800,32,-0.191204588910134
وصنعت,2008-12-28,46891836,22,9,0,7,0,91285,0,91285,0,46891836,0,46891836,0,33,32,33,32,91285,32,-0.191570881226054
وصنعت,2008-12-29,274086336,97,25,2,11,0,519365,20000,539365,0,263746336,10340000,274086336,0,33,31,32,31,539365,32,-1.7274472168906
وصنعت,2009-01-05,415537010,116,4,1,16,0,35000,801000,836000,0,16460000,399077010,415537010,0,35,31,31,34,836000,34,7.57575757575758
وصنعت,2009-01-10,16470300,7,2,0,1,0,34100,0,34100,0,16470300,0,16470300,0,33,33,33,33,34100,34,-0.201207243460765
وصنعت,2009-01-11,2286608,3,3,0,1,0,4744,0,4744,0,2286608,0,2286608,0,33,33,33,33,4744,34,0
وصنعت,2009-01-12,247643031,100,10,2,16,0,386023,110000,496023,0,192112580,55530451,247643031,0,35,33,33,35,496023,34,0.403225806451613
وصنعت,2009-01-13,182379347,80,19,1,14,0,336841,20000,356841,0,172139347,10240000,182379347,0,35,33,35,35,356841,35,1.20481927710843
وصنعت,2009-01-14,56772900,20,3,0,4,0,116100,0,116100,0,56772900,0,56772900,0,34,34,34,34,116100,35,-0.396825396825397
وصنعت,2009-01-17,176214619,71,0,1,5,1,0,361837,351837,10000,0,176214619,171344619,4870000,34,34,34,34,361837,34,-1.39442231075697
وصنعت,2009-01-20,9620000,2,1,0,1,0,20000,0,20000,0,9620000,0,9620000,0,33,33,33,33,20000,34,0
وصنعت,2009-01-26,27976403,12,0,2,5,1,0,58163,48163,10000,0,27976403,23166403,4810000,33,33,33,33,58163,34,-0.202020202020202
وصنعت,2009-01-27,689490000,312,16,1,20,0,436000,1000000,1436000,0,209465000,480025000,689490000,0,35,33,33,33,1436000,33,-2.83400809716599
وصنعت,2009-01-28,603908674,192,33,0,10,1,1295510,0,1289510,6000,603908674,0,601028674,2880000,33,32,32,32,1295510,32,-2.91666666666667
وصنعت,2009-01-31,38858184,22,9,0,4,0,85628,0,85628,0,38858184,0,38858184,0,31,31,31,31,85628,32,-0.214592274678112
وصنعت,2009-02-01,2919513,2,1,0,2,0,6333,0,6333,0,2919513,0,2919513,0,32,32,32,32,6333,32,0
وصنعت,2009-02-02,28923586,13,7,0,3,0,63566,0,63566,0,28923586,0,28923586,0,33,31,33,31,63566,32,-0.21505376344086
وصنعت,2009-02-03,2255000,1,1,0,1,0,5000,0,5000,0,2255000,0,2255000,0,31,31,31,31,5000,32,0
وصنعت,2009-02-04,31570000,16,1,1,6,0,20000,50000,70000,0,9020000,22550000,31570000,0,31,31,31,31,70000,32,-0.21551724137931
وصنعت,2009-02-08,198000,1,1,0,1,0,440,0,440,0,198000,0,198000,0,31,31,31,31,440,32,0
وصنعت,2009-02-11,30276000,12,2,0,4,0,67280,0,67280,0,30276000,0,30276000,0,31,31,31,31,67280,32,-0.215982721382289
وصنعت,2009-02-14,22450000,5,1,0,1,0,50000,0,50000,0,22450000,0,22450000,0,31,31,31,31,50000,32,-0.216450216450216
وصنعت,2009-02-15,448000,1,0,1,1,0,0,1000,1000,0,0,448000,448000,0,31,31,31,31,1000,31,-2.81995661605206
وصنعت,2009-02-18,17400000,4,2,0,1,1,40000,0,30000,10000,17400000,0,13050000,4350000,30,30,30,30,40000,31,-0.223214285714286
وصنعت,2009-02-21,434000,1,0,1,1,0,0,1000,1000,0,0,434000,434000,0,30,30,30,30,1000,30,-2.9082774049217
وصنعت,2009-02-22,795690,2,2,0,1,0,1890,0,1890,0,795690,0,795690,0,29,29,29,29,1890,29,-2.99539170506912
وصنعت,2009-03-03,409000,1,0,1,1,0,0,1000,1000,0,0,409000,409000,0,28,28,28,28,1000,28,-2.85035629453682
وصنعت,2009-03-04,397000,1,0,1,1,0,0,1000,1000,0,0,397000,397000,0,27,27,27,27,1000,27,-2.93398533007335
وصنعت,2009-03-07,19483736,11,3,0,2,0,50476,0,50476,0,19483736,0,19483736,0,27,27,27,27,50476,27,-0.251889168765743
وصنعت,2009-03-09,385000,1,1,0,1,0,1000,0,1000,0,385000,0,385000,0,27,27,27,27,1000,27,-2.77777777777778
وصنعت,2009-03-10,24328700,16,2,2,6,0,15000,50050,65050,0,5610000,18718700,24328700,0,26,26,26,26,65050,26,-0.25974025974026
وصنعت,2009-03-11,41030000,23,2,0,4,1,110000,0,60000,50000,41030000,0,22380000,18650000,26,26,26,26,110000,26,-0.520833333333333
وصنعت,2009-03-14,4953592,5,3,0,3,0,13352,0,13352,0,4953592,0,4953592,0,26,26,26,26,13352,26,0
وصنعت,2009-03-16,7290150,3,2,0,1,0,19650,0,19650,0,7290150,0,7290150,0,26,26,26,26,19650,26,0
وصنعت,2009-03-17,37100000,20,1,0,2,0,100000,0,100000,0,37100000,0,37100000,0,26,26,26,26,100000,26,-0.261780104712042
وصنعت,2009-03-18,352823029,202,29,0,20,1,953153,0,952957,196,352823029,0,352750509,72520,26,26,26,26,953153,26,-2.88713910761155
وصنعت,2009-03-25,14648985,8,2,0,1,1,39000,0,9000,30000,14648985,0,3429000,11219985,26,26,26,26,39000,26,0
وصنعت,2009-03-28,63467391,36,10,1,2,0,169558,6000,175558,0,61247391,2220000,63467391,0,26,25,26,25,175558,25,-0.540540540540541
وصنعت,2009-03-29,27524770,16,3,0,2,1,72630,0,10100,62530,27524770,0,3825900,23698870,26,25,25,26,72630,25,0.271739130434783
وصنعت,2009-03-30,11539108,9,3,0,2,1,30683,0,20938,9745,11539108,0,7874688,3664420,26,26,26,26,30683,25,0
وصنعت,2009-03-31,2904600,1,1,0,0,1,7725,0,0,7725,2904600,0,0,2904600,26,26,26,26,7725,25,0
وصنعت,2009-04-05,114038000,56,16,0,1,1,300100,0,100,300000,114038000,0,38000,114000000,26,26,26,26,300100,26,1.0840108401084
وصنعت,2009-04-06,73836153,27,11,0,3,1,192359,0,92359,100000,73836153,0,35436153,38400000,26,26,26,26,192359,26,0.804289544235925
وصنعت,2009-04-07,85386132,35,9,0,1,1,220636,0,20636,200000,85386132,0,7986132,77400000,27,27,27,27,220636,26,0.797872340425532
وصنعت,2009-04-08,60115140,26,5,0,2,1,154364,0,54364,100000,60115140,0,21161960,38953180,27,27,27,27,154364,26,0.527704485488127
وصنعت,2009-04-11,145402819,88,18,1,3,0,341229,50000,391229,0,126902819,18500000,145402819,0,26,26,26,26,391229,26,-1.31233595800525
وصنعت,2009-04-12,51391336,31,7,0,6,1,136176,0,36176,100000,51391336,0,13791336,37600000,27,26,27,26,136176,26,0
وصنعت,2009-04-13,68162576,41,9,0,10,0,182720,0,182720,0,68162576,0,68162576,0,26,25,26,26,182720,26,-0.265957446808511
وصنعت,2009-04-14,44827865,32,4,1,10,0,98329,20000,118329,0,37328495,7499370,44827865,0,27,26,26,27,118329,26,0.266666666666667
وصنعت,2009-04-15,68825328,41,8,0,5,0,177848,0,177848,0,68825328,0,68825328,0,27,27,27,27,177848,26,0.797872340425532
وصنعت,2009-04-18,202817470,56,13,0,3,1,520065,0,20065,500000,202817470,0,7817470,195000000,27,26,27,27,520065,27,2.11081794195251
وصنعت,2009-04-19,31143898,11,2,0,4,0,78251,0,78251,0,31143898,0,31143898,0,27,27,27,27,78251,27,0.258397932816537
وصنعت,2009-04-20,464835,1,1,0,1,0,1165,0,1165,0,464835,0,464835,0,28,28,28,28,1165,27,0
وصنعت,2009-04-25,39900000,20,2,0,3,0,100000,0,100000,0,39900000,0,39900000,0,28,28,28,28,100000,27,0.257731958762887
وصنعت,2009-04-26,420678800,218,37,0,7,1,1051697,0,951697,100000,420678800,0,380678800,40000000,28,28,28,28,1051697,28,2.82776349614396
وصنعت,2009-04-27,686804,1,1,0,1,0,1667,0,1667,0,686804,0,686804,0,28,28,28,28,1667,28,0
وصنعت,2009-04-28,4120000,2,2,0,1,0,10000,0,10000,0,4120000,0,4120000,0,28,28,28,28,10000,28,0
وصنعت,2009-04-29,618000,1,1,0,1,0,1500,0,1500,0,618000,0,618000,0,28,28,28,28,1500,28,0
وصنعت,2009-05-02,1044420,1,1,0,1,0,2535,0,2535,0,1044420,0,1044420,0,28,28,28,28,2535,28,0
وصنعت,2009-05-09,4120000,2,2,0,1,0,10000,0,10000,0,4120000,0,4120000,0,28,28,28,28,10000,28,0
وصنعت,2009-05-10,23072000,12,4,0,2,0,56000,0,56000,0,23072000,0,23072000,0,28,28,28,28,56000,28,0.25
وصنعت,2009-05-11,4130,1,1,0,1,0,10,0,10,0,4130,0,4130,0,28,28,28,28,10,28,0
وصنعت,2009-05-12,6335833,8,1,0,3,0,15341,0,15341,0,6335833,0,6335833,0,28,28,28,28,15341,28,2.9925187032419
وصنعت,2009-05-16,42500,1,1,0,1,0,100,0,100,0,42500,0,42500,0,29,29,29,29,100,29,2.90556900726392
وصنعت,2009-05-17,1567519,2,1,0,2,0,3587,0,3587,0,1567519,0,1567519,0,30,30,30,30,3587,30,2.82352941176471
وصنعت,2009-05-18,33578100,10,2,0,4,0,74618,0,74618,0,33578100,0,33578100,0,31,31,31,31,74618,31,2.97482837528604
وصنعت,2009-05-19,71339503,36,8,0,7,0,154081,0,154081,0,71339503,0,71339503,0,32,32,32,32,154081,31,0.666666666666667
وصنعت,2009-05-30,5042737968,1440,190,2,127,5,8464314,80000,7754314,790000,4996237968,46500000,4576717968,466020000,47,39,42,43,8544314,41,30.242825607064
وصنعت,2009-05-31,167262492,59,17,0,13,1,275556,0,265556,10000,167262492,0,161192492,6070000,42,42,42,42,275556,41,1.01694915254237
وصنعت,2009-06-01,465551432,156,30,1,9,1,633651,125813,259464,500000,388428063,77123369,159051432,306500000,42,42,42,42,759464,42,2.85234899328859
وصنعت,2009-06-02,473496721,154,34,0,18,2,750391,0,627391,123000,473496721,0,395883721,77613000,44,44,44,44,750391,44,2.93637846655791
وصنعت,2009-06-03,486393050,89,39,0,10,1,749450,0,75450,674000,486393050,0,48967050,437426000,45,45,45,45,749450,45,2.85261489698891
وصنعت,2009-06-06,2649949834,717,118,0,146,1,4048298,0,3922798,125500,2649949834,0,2566283834,83666000,46,43,46,44,4048298,45,0.924499229583975
وصنعت,2009-06-07,122129096,41,9,0,9,0,191951,0,191951,0,122129096,0,122129096,0,44,44,44,44,191951,45,-0.763358778625954
وصنعت,2009-06-08,834060636,297,19,1,34,0,1200848,120000,1320848,0,758340636,75720000,834060636,0,44,44,44,44,1320848,44,-2.92307692307692
وصنعت,2009-06-09,1917889612,1117,49,0,35,0,2956028,0,2956028,0,1917889612,0,1917889612,0,45,44,44,45,2956028,45,2.85261489698891
وصنعت,2009-06-10,692884289,212,45,0,35,0,1038598,0,1038598,0,692884289,0,692884289,0,46,46,46,46,1038598,46,2.77349768875193
وصنعت,2009-06-13,618025743,189,16,0,25,0,954965,0,954965,0,618025743,0,618025743,0,45,45,45,45,954965,45,-2.99850074962519
وصنعت,2009-06-14,91026088,32,6,0,6,0,144946,0,144946,0,91026088,0,91026088,0,43,43,43,43,144946,44,-0.618238021638331
وصنعت,2009-06-16,6240000,1,1,0,1,0,10000,0,10000,0,6240000,0,6240000,0,43,43,43,43,10000,44,0
وصنعت,2009-06-17,205427040,66,6,0,9,0,329210,0,329210,0,205427040,0,205427040,0,43,43,43,43,329210,44,-1.24416796267496
وصنعت,2009-06-20,12320000,2,1,0,1,0,20000,0,20000,0,12320000,0,12320000,0,42,42,42,42,20000,44,-0.15748031496063
وصنعت,2009-06-21,615000,1,1,0,1,0,1000,0,1000,0,615000,0,615000,0,42,42,42,42,1000,44,0
وصنعت,2009-06-22,3287231965,1083,152,0,65,3,5335831,0,2184969,3150862,3287231965,0,1349247417,1937984548,44,42,42,44,5335831,42,-2.8391167192429
وصنعت,2009-06-23,293232412,123,26,0,17,0,471224,0,471224,0,293232412,0,293232412,0,44,42,44,43,471224,43,0.649350649350649
وصنعت,2009-06-24,377434960,214,23,0,20,0,612891,0,612891,0,377434960,0,377434960,0,43,42,43,42,612891,43,-0.483870967741936
وصنعت,2009-06-27,441110913,152,17,1,20,0,616287,120000,736287,0,369230913,71880000,441110913,0,41,41,41,41,736287,41,-2.91734197730956
وصنعت,2009-06-28,784934050,369,27,2,43,0,1088433,260000,1348433,0,633614050,151320000,784934050,0,40,40,40,40,1348433,40,-2.83806343906511
وصنعت,2009-06-29,295257145,144,23,1,15,0,473789,42163,515952,0,271435050,23822095,295257145,0,40,39,39,39,515952,40,-1.20274914089347
وصنعت,2009-06-30,307046420,106,12,0,12,0,518960,0,518960,0,307046420,0,307046420,0,41,39,39,41,518960,40,2.08695652173913
وصنعت,2009-07-01,538043200,164,20,1,19,1,840800,50000,760800,130000,507843200,30200000,459523200,78520000,42,42,42,42,890800,42,2.89608177172061
وصنعت,2009-07-04,123630342,41,16,1,12,0,168148,39020,207168,0,100525522,23104820,123630342,0,43,40,43,41,207168,42,-0.33112582781457
وصنعت,2009-07-05,511278094,162,17,2,17,0,555476,320000,875476,0,324398094,186880000,511278094,0,41,40,40,40,875476,40,-2.99003322259136
وصنعت,2009-07-07,246578513,89,14,0,10,1,433763,0,433580,183,246578513,0,246474752,103761,41,39,40,39,433763,40,-1.54109589041096
وصنعت,2009-07-11,166157646,70,18,2,9,0,277537,20000,297537,0,154997646,11160000,166157646,0,39,38,39,38,297537,39,-1.21739130434783
وصنعت,2009-07-12,9752700,5,3,0,1,0,17700,0,17700,0,9752700,0,9752700,0,38,38,38,38,17700,39,0
وصنعت,2009-07-13,55100,1,1,0,1,0,100,0,100,0,55100,0,55100,0,38,38,38,38,100,39,0
وصنعت,2009-07-14,602935651,203,22,0,35,0,1088326,0,1088326,0,602935651,0,602935651,0,40,38,38,38,1088326,38,-2.46478873239437
وصنعت,2009-07-15,154506244,43,8,0,14,0,276664,0,276664,0,154506244,0,154506244,0,39,37,39,38,276664,38,0.36101083032491
وصنعت,2009-07-18,38141728,16,5,0,5,0,69581,0,69581,0,38141728,0,38141728,0,38,38,38,38,69581,38,-0.179856115107914
وصنعت,2009-07-19,350124931,112,27,0,11,0,645802,0,645802,0,350124931,0,350124931,0,38,37,38,37,645802,38,-1.98198198198198
وصنعت,2009-07-21,145717408,60,13,0,14,0,275961,0,275961,0,145717408,0,145717408,0,36,36,36,36,275961,37,-1.10294117647059
وصنعت,2009-07-22,3721338,3,3,0,1,0,7129,0,7129,0,3721338,0,3721338,0,36,36,36,36,7129,37,0
وصنعت,2009-07-25,605968255,185,21,0,22,1,1159207,0,1070734,88473,605968255,0,559785349,46182906,36,36,36,36,1159207,36,-2.78810408921933
وصنعت,2009-07-26,400709047,154,31,0,18,0,786976,0,786976,0,400709047,0,400709047,0,36,35,36,35,786976,35,-2.67686424474187
وصنعت,2009-07-27,95496120,39,11,0,2,0,193280,0,193280,0,95496120,0,95496120,0,34,34,34,34,193280,35,-0.785854616895874
وصنعت,2009-07-28,467779028,179,21,1,21,0,899932,50000,949932,0,442969028,24810000,467779028,0,35,34,34,34,949932,34,-2.57425742574257
وصنعت,2009-07-29,170725378,73,15,0,13,0,337460,0,337460,0,170725378,0,170725378,0,35,34,34,35,337460,34,1.21951219512195
وصنعت,2009-08-01,112129326,42,12,1,13,0,212022,9573,221595,0,107400264,4729062,112129326,0,35,34,35,34,221595,34,0.401606425702811
وصنعت,2009-08-02,368361309,141,25,1,13,0,546377,200000,746377,0,269540021,98821288,368361309,0,35,33,34,34,746377,34,-1.2
وصنعت,2009-08-03,191680992,81,5,0,12,1,379590,0,378590,1000,191680992,0,191172992,508000,35,34,34,35,379590,34,1.21457489878543
وصنعت,2009-08-04,541457095,193,20,1,4,0,958970,92403,1051373,0,493869550,47587545,541457095,0,36,36,36,36,1051373,36,3
وصنعت,2009-08-05,121287320,41,9,0,8,0,228844,0,228844,0,121287320,0,121287320,0,37,37,37,37,228844,36,0.970873786407767
وصنعت,2009-08-08,78245355,18,1,0,3,0,146253,0,146253,0,78245355,0,78245355,0,37,37,37,37,146253,36,0.576923076923077
وصنعت,2009-08-10,51445712,20,7,0,7,0,95624,0,95624,0,51445712,0,51445712,0,37,37,37,37,95624,36,0.382409177820268
وصنعت,2009-08-11,19209420,8,5,0,6,0,35573,0,35573,0,19209420,0,19209420,0,37,37,37,37,35573,36,0.190476190476191
وصنعت,2009-08-12,203613465,50,4,0,2,1,376365,0,61993,314372,203613465,0,33538213,170075252,37,37,37,37,376365,37,1.52091254752852
وصنعت,2009-08-16,7374400,4,1,0,2,0,13408,0,13408,0,7374400,0,7374400,0,38,38,38,38,13408,37,0
وصنعت,2009-08-17,91353900,32,6,0,3,0,166098,0,166098,0,91353900,0,91353900,0,38,38,38,38,166098,37,0.749063670411985
وصنعت,2009-08-18,29683320,11,5,0,2,0,53580,0,53580,0,29683320,0,29683320,0,38,38,38,38,53580,37,0.185873605947955
وصنعت,2009-08-19,5423460,1,1,0,1,0,9772,0,9772,0,5423460,0,5423460,0,38,38,38,38,9772,37,0
وصنعت,2009-08-22,17009640,7,4,0,3,0,30648,0,30648,0,17009640,0,17009640,0,38,38,38,38,30648,37,0.185528756957328
وصنعت,2009-08-23,152344,1,1,0,1,0,274,0,274,0,152344,0,152344,0,38,38,38,38,274,37,0
وصنعت,2009-08-25,6257224,4,1,0,2,0,11254,0,11254,0,6257224,0,6257224,0,38,38,38,38,11254,37,0
وصنعت,2009-08-26,3358240,3,1,0,3,0,6040,0,6040,0,3358240,0,3358240,0,38,38,38,38,6040,37,0
وصنعت,2009-08-29,87114636,36,8,0,5,0,156681,0,156681,0,87114636,0,87114636,0,38,38,38,38,156681,38,2.96296296296296
وصنعت,2009-08-30,2083361801,732,91,3,53,3,2845005,800000,2834005,811000,1625915711,457446090,1619469801,463892000,39,38,39,39,3645005,39,2.87769784172662
وصنعت,2009-08-31,445652935,119,23,0,14,1,756915,0,754512,2403,445652935,0,444237568,1415367,41,41,41,41,756915,41,2.97202797202797
وصنعت,2009-09-01,15033648,6,2,0,3,0,24808,0,24808,0,15033648,0,15033648,0,42,42,42,42,24808,41,0.169779286926995
وصنعت,2009-09-02,11064396,3,1,0,2,0,18228,0,18228,0,11064396,0,11064396,0,42,42,42,42,18228,41,0
وصنعت,2009-09-14,4017937170,1078,126,3,113,0,5490657,765000,6255657,0,3525657068,492280102,4017937170,0,48,41,48,43,6255657,44,8.8135593220339
وصنعت,2009-09-15,200733812,66,11,1,6,0,271844,50000,321844,0,169583812,31150000,200733812,0,44,43,43,43,321844,44,-1.24610591900312
وصنعت,2009-09-16,68290830,23,3,0,3,0,111042,0,111042,0,68290830,0,68290830,0,42,42,42,42,111042,44,-0.473186119873817
وصنعت,2009-09-19,28477528,10,4,0,1,0,46456,0,46456,0,28477528,0,28477528,0,42,42,42,42,46456,43,-0.158478605388273
وصنعت,2009-09-21,7420500,3,2,0,1,0,12125,0,12125,0,7420500,0,7420500,0,42,42,42,42,12125,43,0
وصنعت,2009-09-22,1680372639,549,70,1,72,0,2649316,83362,2732678,0,1629305095,51067544,1680372639,0,44,42,42,43,2732678,42,-2.38095238095238
وصنعت,2009-09-23,570725710,187,19,0,32,0,902324,0,902324,0,570725710,0,570725710,0,44,42,43,44,902324,44,2.92682926829268
وصنعت,2009-09-26,479506087,147,32,1,32,0,692939,80000,772939,0,430076087,49430000,479506087,0,44,42,44,43,772939,43,-2.05371248025276
وصنعت,2009-09-27,779655964,247,37,0,25,0,1291342,0,1291342,0,779655964,0,779655964,0,43,42,42,42,1291342,42,-2.58064516129032
وصنعت,2010-03-27,187901650,13,3,0,7,0,178333,0,178333,0,187901650,0,187901650,0,79,77,77,79,178333,76,0.58252427184466
وصنعت,2010-03-28,197344480,7,3,0,5,1,184090,0,84090,100000,197344480,0,90144480,107200000,79,79,79,79,184090,77,0.868725868725869
وصنعت,2010-03-29,1076790403,63,25,0,37,2,1000264,0,800264,200000,1076790403,0,860790403,216000000,80,78,80,78,1000264,79,3.0622009569378
وصنعت,2010-03-30,887959610,67,35,3,14,1,560891,290000,814526,36365,585569610,302390000,849945512,38014098,79,77,79,77,850891,77,-3.06406685236769
وصنعت,2010-03-31,690731699,58,30,0,24,0,667774,0,667774,0,690731699,0,690731699,0,77,75,77,77,667774,76,-0.862068965517241
وصنعت,2010-04-03,5153156744,215,68,4,36,3,2765448,2050000,3515448,1300000,2958275137,2194881607,3760856744,1392300000,79,76,76,79,4815448,79,3.38164251207729
وصنعت,2010-04-04,3568818587,254,74,5,40,3,2098673,1300000,2997887,400786,2224518587,1344300000,3153516649,415301938,81,76,80,76,3398673,77,-1.86915887850467
وصنعت,2010-04-05,1862186894,68,22,3,24,1,567723,1236650,1126973,677400,586017744,1276169150,1163787494,698399400,77,76,76,76,1804373,76,-1.71428571428571
وصنعت,2010-04-06,1081840357,75,29,0,34,0,1044415,0,1044415,0,1081840357,0,1081840357,0,79,76,76,77,1044415,76,0.387596899224806
وصنعت,2010-04-07,1332594302,108,58,2,44,0,1190872,110000,1300872,0,1221494302,111100000,1332594302,0,77,74,77,75,1300872,75,-1.15830115830116
وصنعت,2010-04-10,2014865992,118,53,2,34,1,1914315,65200,1968515,11000,1948348792,66517200,2003703992,11162000,78,74,78,75,1979515,75,-0.5859375
وصنعت,2010-04-11,2607544260,185,57,1,44,1,2233615,384800,2568415,50000,2221950660,385593600,2558004260,49540000,75,72,75,73,2618415,73,-2.16110019646365
وصنعت,2010-04-12,2105925805,142,30,1,59,1,2134499,10000,1994499,150000,2096165805,9760000,1957850384,148075421,74,71,73,73,2144499,72,-1.40562248995984
وصنعت,2010-04-13,1653713775,115,34,2,42,0,971863,680973,1652836,0,971430785,682282990,1653713775,0,74,73,73,74,1652836,74,1.93482688391039
وصنعت,2010-04-14,1788888438,112,47,2,24,3,1061622,759508,690781,1130349,1035843438,753045000,676086004,1112802434,75,71,74,71,1821130,72,-1.8981018981019
وصنعت,2010-04-17,1274507879,82,22,2,18,1,1173640,169519,467555,875604,1113503867,161004012,444230933,830276946,74,70,74,70,1343159,70,-3.36048879837067
وصنعت,2010-04-18,454472546,13,6,0,7,1,462803,0,49303,413500,454472546,0,48415546,406057000,72,72,72,72,462803,71,2.10748155953635
وصنعت,2010-04-19,202524240,8,3,0,6,1,202120,0,102120,100000,202524240,0,102324240,100200000,74,74,74,74,202120,72,0.928792569659443
وصنعت,2010-04-20,305648288,16,4,0,13,0,302024,0,302024,0,305648288,0,305648288,0,75,75,75,75,302024,73,1.43149284253579
وصنعت,2010-04-21,2746792604,188,61,2,63,2,2282047,400000,2178968,503079,2337178553,409614051,2231924520,514868084,76,74,76,76,2682047,75,3.2258064516129
وصنعت,2010-04-24,568426688,62,27,0,28,1,556025,0,537125,18900,568426688,0,549375242,19051446,77,73,77,74,556025,75,-0.09765625
وصنعت,2010-04-25,1601213069,99,28,4,40,0,506745,1100000,1606745,0,503422510,1097790559,1601213069,0,76,73,75,73,1606745,73,-2.54154447702835
وصنعت,2010-04-26,632112187,48,18,0,19,0,645613,0,645613,0,632112187,0,632112187,0,75,71,74,72,645613,72,-1.50451354062187
وصنعت,2010-04-27,1267812264,78,25,0,35,0,1278413,0,1278413,0,1267812264,0,1267812264,0,75,71,72,73,1278413,73,1.0183299389002
وصنعت,2010-04-28,852754465,58,36,1,17,0,722991,146184,869175,0,710809801,141944664,852754465,0,74,72,74,72,869175,72,-1.10887096774194
وصنعت,2010-05-01,333723090,37,15,0,21,1,339401,0,335401,4000,333723090,0,329779090,3944000,73,72,73,73,339401,72,0.101936799184506
وصنعت,2010-05-02,504368200,60,37,0,21,0,525770,0,525770,0,504368200,0,504368200,0,72,70,72,71,525770,71,-1.62932790224033
وصنعت,2010-05-03,423510753,82,29,1,34,0,423412,15239,438651,0,408911791,14598962,423510753,0,73,70,73,71,438651,71,0
وصنعت,2010-05-04,1174094589,78,23,4,37,1,832518,346927,779445,400000,829638576,344456013,774494589,399600000,74,72,72,74,1179445,73,3.00207039337474
وصنعت,2010-05-05,497586704,45,70,0,13,0,513875,0,513875,0,497586704,0,497586704,0,74,71,74,71,513875,72,-1.80904522613065
وصنعت,2010-05-08,661274912,60,28,0,26,1,699955,0,599955,100000,661274912,0,566865210,94409702,73,70,70,70,699955,70,-3.07062436028659
وصنعت,2010-05-09,623620509,58,23,1,30,1,613926,38577,632503,20000,587082089,36538420,604360509,19260000,71,69,69,70,652503,70,0.844772967265048
وصنعت,2010-05-10,1116110055,107,59,2,29,1,1028313,157000,1118988,66325,968871055,147239000,1053580555,62529500,71,69,71,69,1185313,69,-1.36125654450262
وصنعت,2010-05-11,506419423,42,18,0,18,0,539942,0,539942,0,506419423,0,506419423,0,71,69,71,70,539942,69,-0.318471337579618
وصنعت,2010-05-12,1665120838,111,45,1,42,1,1670329,50000,957601,762728,1616570838,48550000,924511950,740608888,72,68,68,72,1720329,71,3.08839190628328
وصنعت,2010-05-15,550223674,21,14,0,9,0,549674,0,549674,0,550223674,0,550223674,0,74,74,74,74,549674,73,2.47933884297521
وصنعت,2010-05-16,688660434,26,15,0,14,1,671209,0,571209,100000,688660434,0,586060434,102600000,76,76,76,76,671209,75,3.0241935483871
وصنعت,2010-05-18,752893701,22,18,1,8,1,662293,50000,512293,200000,700043701,52850000,541493701,211400000,78,78,78,78,712293,78,3.22896281800391
وصنعت,2010-05-19,9665659676,352,173,5,88,6,4778653,4170000,5667594,3281059,5119135676,4546524000,6100626527,3565033149,80,75,80,77,8948653,80,2.3696682464455
وصنعت,2010-05-22,58294313,6,3,0,4,0,55891,0,55891,0,58294313,0,58294313,0,77,77,77,77,55891,79,-0.277777777777778
وصنعت,2010-05-23,24326640,3,3,0,1,0,23391,0,23391,0,24326640,0,24326640,0,77,77,77,77,23391,79,-0.092850510677809
وصنعت,2010-05-24,10390000,1,1,0,1,0,10000,0,10000,0,10390000,0,10390000,0,77,77,77,77,10000,79,0
وصنعت,2010-05-25,11429000,2,1,1,1,0,10000,1000,11000,0,10390000,1039000,11429000,0,77,77,77,77,11000,79,-0.092936802973978
وصنعت,2010-05-26,1532088,2,2,0,1,0,1476,0,1476,0,1532088,0,1532088,0,77,77,77,77,1476,79,0
وصنعت,2010-05-30,1048380,2,2,0,1,0,1010,0,1010,0,1048380,0,1048380,0,77,77,77,77,1010,79,0
وصنعت,2010-06-01,127200672,6,5,0,2,0,122544,0,122544,0,127200672,0,127200672,0,77,77,77,77,122544,79,-0.558139534883721
وصنعت,2010-06-02,9438339591,379,89,2,145,4,3892146,5244015,8240347,895814,4026516111,5411823480,8512132763,926206828,77,76,76,76,9136161,76,-3.36763330215154
وصنعت,2010-06-06,996839849,80,42,0,28,1,974435,0,973435,1000,996839849,0,995817849,1022000,77,74,77,75,974435,75,-0.968054211035818
وصنعت,2010-06-07,738853433,62,31,0,28,2,740311,0,683061,57250,738853433,0,681482828,57370605,75,73,75,73,740311,74,-2.44379276637341
وصنعت,2010-06-08,661312821,64,39,0,16,0,670369,0,670369,0,661312821,0,661312821,0,74,72,73,72,670369,73,-1.00200400801603
وصنعت,2010-06-09,1138036871,88,47,1,23,1,1082606,100000,1132606,50000,1041436871,96600000,1089392321,48644550,74,70,72,71,1182606,71,-2.63157894736842
وصنعت,2010-06-12,347169713,25,17,0,6,0,361600,0,361600,0,347169713,0,347169713,0,72,70,72,71,361600,71,-0.103950103950104
وصنعت,2010-06-13,876266604,67,37,0,27,1,884194,0,784194,100000,876266604,0,777066604,99200000,73,71,71,72,884194,73,3.12174817898023
وصنعت,2010-06-14,625634274,54,44,2,20,0,488338,143000,631338,0,484744274,140890000,625634274,0,75,72,73,72,631338,73,0
وصنعت,2010-06-15,1497880675,74,32,0,36,1,1461347,0,461347,1000000,1497880675,0,472880675,1025000000,76,76,76,76,1461347,76,3.43087790110999
وصنعت,2010-06-16,7841581795,396,148,4,114,6,6212715,1198280,4884587,2526408,6574587795,1266994000,5165161109,2676420686,78,77,78,78,7410995,78,3.21951219512195
وصنعت,2010-06-19,2051024712,129,50,3,46,1,1508454,470000,1776324,202130,1562158809,488865903,1839335644,211689068,79,75,79,75,1978454,76,-1.98487712665406
وصنعت,2010-06-20,2194612905,174,62,3,37,1,1999645,191471,2091116,100000,2002950434,191662471,2094497136,100115769,74,74,74,74,2191116,74,-3.37512054001929
وصنعت,2010-06-21,790856152,64,25,0,18,2,794190,0,478542,315648,790856152,0,476290154,314565998,74,72,74,74,794190,73,-0.598802395209581
وصنعت,2010-06-22,883721256,57,22,0,27,3,858746,0,691524,167222,883721256,0,711706482,172014774,76,73,73,75,858746,76,3.31325301204819
وصنعت,2010-06-23,337528864,37,22,1,15,0,233375,100000,333375,0,236828864,100700000,337528864,0,77,74,76,74,333375,75,-0.680272108843537
وصنعت,2010-06-27,367563974,29,14,0,13,0,362933,0,362933,0,367563974,0,367563974,0,76,74,75,74,362933,75,-0.391389432485323
وصنعت,2010-06-28,648688594,81,35,0,17,0,647898,0,647898,0,648688594,0,648688594,0,75,73,75,73,647898,74,-1.37524557956778
وصنعت,2010-06-29,526690731,58,29,1,25,2,488276,46281,463451,71106,481705599,44985132,456826585,69864146,74,72,73,73,534557,73,-1.29482071713147
وصنعت,2010-06-30,910243148,69,37,1,24,2,904919,19540,760565,163894,890898548,19344600,748049344,162193804,74,72,72,73,924459,73,-0.605449041372351
وصنعت,2010-07-03,1001656891,100,44,1,18,0,968799,50000,1018799,0,952506891,49150000,1001656891,0,74,72,73,72,1018799,72,-0.203045685279188
وصنعت,2010-07-04,588936369,62,25,1,18,0,498634,100000,598634,0,489129743,99806626,588936369,0,74,72,73,72,598634,73,0.101729399796541
وصنعت,2010-07-05,760141566,75,40,1,37,0,657103,100000,757103,0,658266488,101875078,760141566,0,75,72,73,74,757103,74,2.03252032520325
وصنعت,2010-07-06,621840700,49,28,0,18,1,621273,0,571273,50000,621840700,0,571475700,50365000,76,73,76,73,621273,74,-0.298804780876494
وصنعت,2010-07-07,501661089,44,17,0,26,0,502446,0,502446,0,501661089,0,501661089,0,74,73,73,73,502446,74,-0.1998001998002
وصنعت,2010-07-11,634199946,52,26,1,24,1,524305,100000,595791,28514,532060760,102139186,605315264,28884682,76,74,74,75,624305,75,1.4014014014014
وصنعت,2010-07-12,575258507,54,23,0,20,0,574471,0,574471,0,575258507,0,575258507,0,75,73,75,73,574471,74,-0.888450148075025
وصنعت,2010-07-13,496529025,46,16,0,26,2,496166,0,416166,80000,496529025,0,416049025,80480000,74,73,73,73,496166,74,-0.199203187250996
وصنعت,2010-07-14,723311221,80,30,0,30,0,725880,0,725880,0,723311221,0,723311221,0,74,73,74,74,725880,73,-0.499001996007984
وصنعت,2010-07-17,5420476991,243,78,2,87,3,5065501,180000,3695501,1550000,5234546991,185930000,3814676991,1605800000,76,73,74,76,5245501,76,3.61083249749248
وصنعت,2010-07-18,7064323270,530,152,4,108,1,6197676,404129,5601805,1000000,6630743536,433579734,5993364148,1070959122,79,77,77,79,6601805,79,3.58180058083253
وصنعت,2010-07-19,8144946256,351,131,1,116,6,6088962,1250000,3145390,4193572,6754946256,1390000000,3485670796,4659275460,82,80,82,81,7338962,82,3.73831775700935
وصنعت,2010-07-20,4134327812,292,103,3,90,2,3700001,120000,2870001,950000,4004637812,129690000,3107631169,1026696643,82,79,82,79,3820001,80,-2.52252252252252
وصنعت,2010-07-21,5458165377,394,53,4,133,5,1460762,3540000,4629938,370824,1587361163,3870804214,5052269015,405896362,82,79,82,81,5000762,80,0.831792975970425
وصنعت,2010-07-24,484371726,71,32,1,25,1,399603,50000,427218,22385,429871726,54500000,460315836,24055890,81,78,80,78,449603,80,-0.73327222731439
وصنعت,2010-07-25,2395549282,333,60,2,72,4,2079071,110000,1749101,439970,2274559282,120990000,1911619686,483929596,81,79,79,80,2189071,81,1.01569713758079
وصنعت,2010-07-26,1843986891,148,54,0,55,2,1674678,0,1254678,420000,1843986891,0,1382252967,461733924,82,80,81,81,1674678,81,0.639853747714808
وصنعت,2010-07-28,1346976095,132,58,0,51,2,1227214,0,1069879,157335,1346976095,0,1174424245,172551850,82,80,82,80,1227214,81,-0.272479564032698
وصنعت,2010-07-31,939997395,109,30,0,34,2,858197,0,734180,124017,939997395,0,804718865,135278530,81,80,81,80,858197,81,-0.273224043715847
وصنعت,2010-08-01,983510192,87,45,1,33,1,908121,10000,818121,100000,972960192,10550000,876825981,106684211,81,78,81,79,918121,79,-2.19178082191781
وصنعت,2010-08-02,1380576630,121,47,0,42,1,1268237,0,1045137,223100,1380576630,0,1135612830,244963800,81,78,78,81,1268237,80,1.68067226890756
وصنعت,2010-08-03,7699527113,363,144,3,64,8,6538476,280000,1773476,5045000,7382567113,316960000,1992209193,5707317920,83,81,81,83,6818476,83,3.67309458218549
وصنعت,2010-08-04,3286690883,275,107,2,70,2,2650053,250000,2268299,631754,3003130950,283559933,2571458896,715231987,85,82,85,83,2900053,84,0.354295837023915
وصنعت,2010-08-07,3962954705,313,133,0,77,2,3399620,0,2502191,897429,3962954705,0,2917077978,1045876727,87,84,84,86,3399620,86,2.9126213592233
وصنعت,2010-08-08,5617756589,339,143,7,52,4,4236200,552000,1858321,2929879,4970020829,647735760,2199787709,3417968880,89,85,88,86,4788200,86,0.600343053173242
وصنعت,2010-08-09,2199204057,202,83,0,42,4,1861936,0,1455615,406321,2199204057,0,1719081045,480123012,88,86,87,87,1861936,87,0.682011935208866
وصنعت,2010-08-10,7691147587,264,99,3,59,6,4645871,1640000,1663900,4621971,5677227587,2013920000,2028295199,5662852388,91,88,88,91,6285871,90,3.64098221845893
وصنعت,2010-08-11,5121752871,272,145,0,83,5,4097113,0,2855466,1241647,5121752871,0,3553643534,1568109337,94,89,94,90,4097113,92,2.12418300653595
وصنعت,2010-08-14,895751606,78,43,1,29,0,730493,10000,740493,0,883751606,12000000,895751606,0,92,88,92,88,740493,89,-3.2
وصنعت,2010-08-15,2469871174,191,82,3,61,3,1911592,210000,1976592,145000,2225541174,244330000,2301363964,168507210,87,86,86,86,2121592,86,-3.80165289256198
وصنعت,2010-08-16,2478913703,170,65,0,63,4,2088707,0,1008707,1080000,2478913703,0,1192873703,1286040000,88,84,84,87,2088707,88,1.97594501718213
وصنعت,2010-08-17,3738893753,238,117,1,47,2,3019847,100000,2319847,800000,3617893753,121000000,2776978742,961915011,90,87,89,87,3119847,88,0.92670598146588
وصنعت,2010-08-18,16322664100,543,280,3,87,5,12752667,357973,2646405,10464235,15876987715,445676385,3294691525,13027972575,92,92,92,92,13110640,92,3.92320534223706
وصنعت,2010-08-21,6476174603,451,147,0,172,3,5065817,0,4747844,317973,6476174603,0,6068746377,407428226,95,92,93,93,5065817,94,2.65060240963855
وصنعت,2010-08-22,2795502090,203,92,1,74,1,2182683,50000,2032683,200000,2732735642,62766448,2545423980,250078110,94,90,94,94,2232683,92,-2.03442879499218
وصنعت,2010-08-24,21073252027,576,188,8,138,9,12687359,3837617,6289072,10235904,16155373785,4917878242,7987433811,13085818216,95,89,91,95,16524976,94,1.8370607028754
وصنعت,2010-08-25,1324976328,42,28,1,19,1,989228,10000,149228,850000,1311716328,13260000,197876328,1127100000,98,98,98,98,999228,98,4
وصنعت,2010-08-28,1019387138,18,20,0,10,1,739222,0,39222,700000,1019387138,0,54087138,965300000,102,102,102,102,739222,102,3.92156862745098
وصنعت,2010-08-29,43115132077,1134,369,37,382,14,17593291,12549055,24052346,6090000,25151490239,17963641838,34390845139,8724286938,106,102,106,105,30142346,105,3.77358490566038
وصنعت,2010-08-30,5656287635,317,118,3,124,2,3531543,550000,3580543,501000,4900237635,756050000,4962028547,694259088,108,101,103,101,4081543,102,-3.07692307692308
وصنعت,2010-08-31,6791894838,393,133,1,152,3,4817040,100000,4418040,499000,6653894838,138000000,6102737838,689157000,104,100,101,101,4917040,102,-0.360750360750361
وصنعت,2010-09-04,5793195790,341,149,2,104,4,3834333,300000,3659333,475000,5368880696,424315094,5126725458,666470332,105,101,104,102,4134333,103,1.44822592324403
وصنعت,2010-09-05,5872292478,325,140,1,110,2,4135316,82293,4067609,150000,5755446418,116846060,5662545978,209746500,105,100,104,102,4217609,103,-0.642398286937901
وصنعت,2010-09-06,3554000798,233,123,1,67,4,2602188,10000,2332188,280000,3540500798,13500000,3171600217,382400581,103,99,103,99,2612188,100,-2.22701149425287
وصنعت,2010-09-07,5667549383,287,122,2,77,2,4075074,160000,2635074,1600000,5449636438,217912945,3522446287,2145103096,102,96,100,98,4235074,99,-1.68993387215283
وصنعت,2010-09-08,3450229255,208,96,2,67,3,2235069,350000,1935069,650000,2975840107,474389148,2587178383,863050872,101,96,97,99,2585069,98,-0.224215246636771
وصنعت,2010-09-12,1079522911,101,56,0,34,3,808073,0,530091,277982,1079522911,0,707048675,372474236,100,96,100,97,808073,98,0.074906367041199
وصنعت,2010-09-13,8182786509,411,140,6,143,7,4107700,1960000,4659767,1407933,5491850021,2690936488,6257851063,1924935446,102,95,97,96,6067700,99,0.973053892215569
وصنعت,2010-09-14,1948343045,142,54,0,69,2,1498013,0,1470334,27679,1948343045,0,1912471061,35871984,97,96,96,96,1498013,96,-3.55819125277984
وصنعت,2010-09-15,2352261833,180,75,1,70,1,1802733,14027,1624439,192321,2334026733,18235100,2105392195,246869638,97,94,97,95,1816760,95,-0.461183704842429
وصنعت,2010-09-18,3333630911,216,77,1,70,2,2295761,200000,2041912,453849,3064430911,269200000,2723682213,609948698,99,96,96,97,2495761,98,3.16602316602317
وصنعت,2010-09-19,2595906843,165,62,0,52,2,1973388,0,1565262,408126,2595906843,0,2050573004,545333839,100,95,100,96,1973388,97,-1.57185628742515
وصنعت,2010-09-20,5579206130,296,76,4,85,1,2491180,1850000,4036806,304374,3205218216,2373987914,5189499609,389706521,97,93,97,97,4341180,95,-2.28136882129278
وصنعت,2010-09-21,3231381280,170,59,1,63,2,2028002,400000,1652464,775538,2700423104,530958176,2195338050,1036043230,98,95,96,98,2428002,98,3.57976653696498
وصنعت,2010-09-22,3216163682,193,60,4,84,3,1786482,579620,2135940,230162,2430482756,785680926,2905591593,310572089,101,99,101,100,2366102,100,2.10368144252442
وصنعت,2010-09-25,3626904525,214,68,3,97,4,2391380,230000,2130760,490620,3306498738,320405787,2948312414,678592111,103,101,101,103,2621380,102,1.83958793230316
وصنعت,2010-09-26,3034163216,176,68,3,66,3,1828161,410000,1809161,429000,2480169752,553993464,2451226931,582936285,102,98,102,98,2238161,100,-2.02312138728324
وصنعت,2010-09-27,3133094298,149,41,4,60,1,1960139,385179,1445318,900000,2616293142,516801156,1934534104,1198560194,100,98,100,100,2345318,98,-1.47492625368732
وصنعت,2010-09-28,7403015944,323,76,6,130,5,3951078,1390000,3399956,1941122,5472555944,1930460000,4708007584,2695008360,102,98,98,102,5341078,102,3.74251497005988
وصنعت,2010-09-29,2967199890,202,84,5,80,2,1747515,372000,1356131,763384,2444687492,522512398,1901703502,1065496388,105,101,103,102,2119515,103,1.01010101010101
وصنعت,2010-10-02,2080220984,135,55,2,49,1,1408767,115290,1224057,300000,1923285074,156935910,1671602921,408618063,102,100,102,101,1524057,101,-2.5
وصنعت,2010-10-03,1852793943,111,51,2,37,2,1035370,350000,1231343,154027,1386523943,466270000,1646239798,206554145,100,97,100,98,1385370,99,-2.05128205128205
وصنعت,2010-10-05,2659863834,129,30,3,64,2,1505424,430000,1735424,200000,2069865942,589997892,2386613804,273250030,102,99,99,101,1935424,101,2.76738967838444
وصنعت,2010-10-06,5728734425,264,74,7,97,5,2789653,1348000,3597095,540558,3860801210,1867933215,4981851383,746883042,103,100,102,102,4137653,102,0.800582241630277
وصنعت,2010-10-09,13010013954,524,122,6,161,8,4776254,4373519,6188933,2960840,6772286235,6237727719,8815339623,4194674331,106,102,103,103,9149773,105,2.67148014440433
وصنعت,2010-10-10,5057644123,298,105,4,83,3,3526868,115000,3118525,523343,4898654123,158990000,4313711107,743933016,106,101,103,101,3641868,102,-2.32067510548523
وصنعت,2010-10-11,3952346585,267,99,1,80,6,2803713,50000,2431634,422079,3883346585,69000000,3361755271,590591314,104,100,100,100,2853713,102,-0.287976961843053
وصنعت,2010-10-12,3113032104,198,83,2,53,2,1795336,520000,2274442,40894,2421302104,691730000,3058192736,54839368,103,98,102,98,2315336,99,-2.88808664259928
وصنعت,2010-10-13,473615967,45,23,0,17,0,366566,0,366566,0,473615967,0,473615967,0,95,95,95,95,366566,97,-1.93308550185874
وصنعت,2010-10-16,5975360849,291,134,1,99,2,4592984,67000,4599959,60025,5890369849,84991000,5897859174,77501675,99,93,93,93,4659984,95,-2.80515542077331
وصنعت,2010-10-17,2208378041,147,85,1,43,4,1697918,15000,1585916,127002,2189103041,19275000,2044323893,164054148,97,94,96,94,1712918,95,0.546021840873635
وصنعت,2010-10-18,2766787038,211,96,2,53,3,2025694,110000,1364905,770789,2625125038,141662000,1767808821,998978217,97,94,96,95,2135694,95,0.465477114041893
وصنعت,2010-10-19,1472765710,117,56,1,42,0,1166303,10000,1176303,0,1460325710,12440000,1472765710,0,95,92,95,92,1176303,92,-3.32046332046332
وصنعت,2010-10-20,2337867590,195,96,2,58,2,1882323,55000,1622323,315000,2271757590,66110000,1958707373,379160217,91,89,89,91,1937323,89,-3.59424920127795
وصنعت,2010-10-23,2351562903,160,73,2,52,3,1729884,150000,1309884,570000,2163412903,188150000,1636212903,715350000,93,91,92,92,1879884,92,3.64540182270091
وصنعت,2010-10-24,1018631483,100,59,2,28,0,809158,35000,844158,0,976446483,42185000,1018631483,0,91,89,91,89,844158,89,-3.5171862509992
وصنعت,2010-10-25,1373745811,115,62,1,45,0,1144607,25300,1169907,0,1344220711,29525100,1373745811,0,89,86,89,87,1169907,87,-2.73405136702568
وصنعت,2010-10-26,1373453439,87,37,2,34,1,971543,200100,971643,200000,1138734939,234718500,1138411169,235042270,88,85,86,85,1171643,86,-0.170357751277683
وصنعت,2010-10-27,1500138456,106,51,1,35,2,1245046,190,764034,481202,1499916726,221730,917653838,582484618,90,86,86,89,1245236,89,2.81569965870307
وصنعت,2010-10-30,978525443,111,50,2,25,1,782328,19820,503848,298300,954419053,24106390,615384373,363141070,91,88,89,88,802148,90,1.2448132780083
وصنعت,2010-10-31,617428170,75,45,0,26,0,517422,0,517422,0,617428170,0,617428170,0,90,87,90,87,517422,89,-1.47540983606557
وصنعت,2010-11-01,824230980,89,54,1,19,1,684696,20000,702696,2000,801010980,23220000,821890980,2340000,88,85,88,86,704696,86,-2.49584026622296
وصنعت,2010-11-02,574483697,70,41,1,19,3,484640,10000,288565,206075,562973697,11510000,335483853,238999844,87,85,86,85,494640,86,-0.597269624573379
وصنعت,2010-11-03,1653057121,138,59,1,34,1,1419532,10000,1129532,300000,1641557121,11500000,1307995511,345061610,87,85,87,86,1429532,85,-0.772532188841202
وصنعت,2010-11-06,651368512,87,29,0,30,1,554397,0,534397,20000,651368512,0,627908512,23460000,88,86,86,86,554397,86,1.21107266435986
وصنعت,2010-11-07,1141290219,92,52,2,26,2,929890,61000,960653,30237,1071350219,69940000,1106655299,34634920,88,83,88,85,990890,85,-1.53846153846154
وصنعت,2010-11-08,1462353480,183,25,1,19,1,269355,1000000,625592,643763,310537994,1151815486,720884504,741468976,86,84,85,85,1269355,85,0
وصنعت,2010-11-09,2135832177,146,52,0,40,1,1826277,0,1726277,100000,2135832177,0,2017432177,118400000,87,85,86,87,1826277,86,1.5625
وصنعت,2010-11-10,1238295805,133,47,0,43,4,1037335,0,867335,170000,1238295805,0,1035995805,202300000,89,87,88,87,1037335,88,2.05128205128205
وصنعت,2010-11-13,6226914184,375,83,1,82,6,4923296,100000,2133611,2889685,6102814184,124100000,2641115099,3585799085,91,88,88,91,5023296,91,3.85259631490787
وصنعت,2010-11-14,1293981984,101,51,0,38,0,1056364,0,1056364,0,1293981984,0,1293981984,0,92,88,92,89,1056364,90,-1.20967741935484
وصنعت,2010-11-15,1082514898,119,45,0,38,2,902980,0,892780,10200,1082514898,0,1070036098,12478800,91,88,90,88,902980,88,-2.12244897959184
وصنعت,2010-11-16,1393443419,107,35,1,55,1,1108055,50000,1108055,50000,1334043419,59400000,1333023419,60420000,90,88,88,88,1158055,89,0.333611342785655
وصنعت,2010-11-20,6856222135,361,149,1,57,0,5353470,500000,5853470,0,6259290130,596932005,6856222135,0,90,85,88,86,5853470,86,-2.66001662510391
وصنعت,2010-11-27,2280829367,162,74,0,37,2,2169958,0,2136625,33333,2280829367,0,2245572717,35256650,89,86,89,87,2169958,87,0.960614793467819
وصنعت,2010-11-28,1152511544,111,59,0,40,1,1105547,0,1103747,1800,1152511544,0,1150630544,1881000,89,85,87,85,1105547,86,-0.856327307326356
وصنعت,2010-11-29,876290480,103,43,0,31,1,867970,0,767970,100000,876290480,0,774995480,101295000,85,83,84,84,867970,84,-3.07101727447217
وصنعت,2010-11-30,529936159,59,40,0,17,0,532030,0,532030,0,529936159,0,529936159,0,85,82,85,82,532030,83,-0.99009900990099
وصنعت,2010-12-01,1326488538,126,52,1,31,0,836103,500000,1336103,0,829655029,496833509,1326488538,0,83,81,82,82,1336103,82,-0.7
وصنعت,2010-12-04,1118833601,114,67,0,28,0,1154811,0,1154811,0,1118833601,0,1118833601,0,83,79,83,79,1154811,80,-2.41691842900302
وصنعت,2010-12-05,1429323291,142,73,1,33,1,1515530,10000,1505530,20000,1419973291,9350000,1410523291,18800000,80,77,78,78,1525530,78,-3.30237358101135
وصنعت,2010-12-06,935766600,118,79,0,29,1,1031846,0,981846,50000,935766600,0,890266600,45500000,77,75,77,75,1031846,75,-3.2017075773746
وصنعت,2010-12-07,1675131693,120,43,3,39,1,1423531,383515,1537046,270000,1319753841,355377852,1437413636,237718057,78,72,75,78,1807046,77,2.20507166482911
وصنعت,2010-12-08,735904279,91,36,2,33,0,541890,225058,766948,0,520418599,215485680,735904279,0,80,78,79,80,766948,80,3.55987055016181
وصنعت,2010-12-11,1119502840,145,64,1,35,1,934251,200000,1124251,10000,922374840,197128000,1109652840,9850000,82,81,82,82,1134251,82,2.8125
وصنعت,2010-12-12,796961171,94,49,1,21,1,725361,110822,809517,26666,691851915,105109256,771681803,25279368,82,79,82,79,836183,79,-3.44478216818642
وصنعت,2010-12-13,514256301,74,32,0,24,0,532950,0,532950,0,514256301,0,514256301,0,81,79,80,79,532950,80,0.839454354669465
وصنعت,2010-12-14,288792961,46,25,0,18,0,301844,0,301844,0,288792961,0,288792961,0,80,78,80,79,301844,80,-0.208116545265349
وصنعت,2010-12-18,1076907668,104,49,1,30,0,953562,200000,1153562,0,886849318,190058350,1076907668,0,80,76,79,77,1153562,77,-2.60688216892596
وصنعت,2010-12-19,1073929271,121,67,0,35,0,1190842,0,1190842,0,1073929271,0,1073929271,0,77,74,77,74,1190842,75,-3.42612419700214
وصنعت,2010-12-20,777169517,91,45,0,15,0,847785,0,847785,0,777169517,0,777169517,0,77,75,76,76,847785,76,1.6629711751663
وصنعت,2010-12-21,294913903,50,33,0,12,1,324177,0,224177,100000,294913903,0,204674583,90239320,77,75,76,75,324177,76,-0.327153762268266
وصنعت,2010-12-22,348055962,46,23,0,20,0,380219,0,380219,0,348055962,0,348055962,0,76,75,75,76,380219,76,0.109409190371991
وصنعت,2010-12-25,1236452015,118,39,0,40,0,1311595,0,1311595,0,1236452015,0,1236452015,0,79,76,76,79,1311595,78,3.06010928961749
وصنعت,2010-12-26,1901189889,301,109,0,71,1,1950040,0,1900040,50000,1901189889,0,1853036663,48153226,81,80,81,80,1950040,81,3.39342523860021
وصنعت,2010-12-27,911714317,109,64,0,27,0,959678,0,959678,0,911714317,0,911714317,0,81,78,81,78,959678,79,-2.56410256410256
وصنعت,2010-12-28,377188702,54,20,0,28,0,392856,0,392856,0,377188702,0,377188702,0,80,79,79,80,392856,79,0.526315789473684
وصنعت,2010-12-29,1067686333,123,55,0,39,1,1128948,0,1028948,100000,1067686333,0,972663158,95023175,80,78,80,78,1128948,78,-0.942408376963351
وصنعت,2011-01-01,356582403,46,25,1,17,0,362066,20000,382066,0,337962403,18620000,356582403,0,78,77,78,77,382066,78,-0.634249471458774
وصنعت,2011-01-02,459349164,60,30,1,29,0,393225,100000,493225,0,366149164,93200000,459349164,0,78,76,78,76,493225,77,-0.638297872340426
وصنعت,2011-01-03,1310351203,248,55,2,39,0,1293954,120000,1413954,0,1199406241,110944962,1310351203,0,77,76,77,76,1413954,77,-0.749464668094218
وصنعت,2011-01-04,728295569,108,24,5,36,0,447831,327029,774860,0,420662987,307632582,728295569,0,79,77,77,78,774860,78,1.40237324703344
وصنعت,2011-01-05,623740050,69,43,0,20,0,662634,0,662634,0,623740050,0,623740050,0,79,78,79,78,662634,78,0.106382978723404
وصنعت,2011-01-08,1463956246,143,46,3,82,0,1313670,200000,1513670,0,1269353296,194602950,1463956246,0,81,79,79,81,1513670,80,2.76301806588735
وصنعت,2011-01-09,1147628230,106,48,0,52,1,1143933,0,1083933,60000,1147628230,0,1087628230,60000000,83,82,82,83,1143933,83,3.72285418821096
وصنعت,2011-01-10,1704751780,171,95,0,60,1,1704083,0,1512135,191948,1704751780,0,1513466980,191284800,86,80,86,81,1704083,83,-0.299102691924227
وصنعت,2011-01-11,1049586372,128,52,0,59,0,1051989,0,1051989,0,1049586372,0,1049586372,0,83,80,82,83,1051989,83,-0.2
وصنعت,2011-01-12,1950131155,192,48,0,64,3,1934345,0,1505961,428384,1950131155,0,1516160883,433970272,85,83,84,83,1934345,84,1.00200400801603
وصنعت,2011-01-15,328603006,38,18,0,22,1,326843,0,320146,6697,328603006,0,321880915,6722091,84,83,84,83,326843,84,-0.099206349206349
وصنعت,2011-01-16,1071597567,92,39,0,41,2,1053397,0,818023,235374,1071597567,0,830152587,241444980,85,83,83,85,1053397,84,0.99304865938431
وصنعت,2011-01-17,749851792,92,52,0,31,1,739794,0,643186,96608,749851792,0,651088542,98763250,85,83,85,84,739794,84,-0.294985250737463
وصنعت,2011-01-18,4574907915,233,63,0,79,1,4387861,0,1887861,2500000,4574907915,0,1962676560,2612231355,87,84,84,87,4387861,86,2.85996055226824
وصنعت,2011-01-19,2803486328,47,10,1,20,1,1586242,1000000,323978,2262264,1719486328,1084000000,351192152,2452294176,90,90,90,90,2586242,90,3.93096836049856
وصنعت,2011-01-22,11309457713,458,152,7,141,2,7557020,2494000,5851020,4200000,8498787713,2810670000,6576957713,4732500000,93,90,93,93,10051020,93,3.78228782287823
وصنعت,2011-01-23,2903839234,207,84,3,82,0,2388535,229087,2617622,0,2650205090,253634144,2903839234,0,95,90,95,92,2617622,92,-1.42222222222222
وصنعت,2011-01-24,1929529212,163,65,0,89,1,1693297,0,1593297,100000,1929529212,0,1814529212,115000000,96,91,91,94,1693297,95,2.79531109107304
وصنعت,2011-01-26,2298285189,165,63,0,57,0,1994223,0,1994223,0,2298285189,0,2298285189,0,97,94,94,95,1994223,96,1.05263157894737
وصنعت,2011-01-29,3496147061,179,59,2,62,4,2119813,889295,1091690,1917418,2463164991,1032982070,1267484448,2228662613,98,95,98,96,3009108,96,0.868055555555556
وصنعت,2011-01-30,4506513229,240,45,3,117,3,2433334,1394387,2528569,1299152,2865224082,1641289147,2981442793,1525070436,99,96,96,97,3827721,98,1.29087779690189
وصنعت,2011-01-31,6902898599,389,112,5,109,3,4220228,1441017,2390135,3271110,5151848191,1751050408,2908437663,3994460936,102,98,98,102,5661245,101,3.56839422259983
وصنعت,2011-02-01,11942331373,416,100,12,129,3,4699869,4729813,5039382,4390300,5952012747,5990318626,6380355373,5561976000,105,103,105,105,9429682,105,3.85561936013125
وصنعت,2011-02-05,12391846925,560,167,4,149,4,5026149,4529126,4908597,4646678,6503531747,5888315178,6402080320,5989766605,109,105,109,106,9555275,108,2.44865718799368
وصنعت,2011-02-06,3822980813,260,80,5,118,1,1876258,1185866,2947124,115000,2345176692,1477804121,3679690813,143290000,107,103,107,103,3062124,103,-3.77794911333847
وصنعت,2011-02-07,4193810261,435,163,0,94,4,3379523,0,2221178,1158345,4193810261,0,2756010624,1437799637,106,100,102,102,3379523,103,-0.560897435897436
وصنعت,2011-02-08,2232230693,212,96,1,81,1,1826512,31500,1758012,100000,2194682693,37548000,2112930693,119300000,102,99,102,99,1858012,100,-3.2232070910556
وصنعت,2011-02-09,1949034234,200,111,2,57,3,1514905,120000,1204905,430000,1804844710,144189524,1439904905,509129329,101,98,98,98,1634905,99,-0.749375520399667
وصنعت,2011-02-12,846813004,98,60,2,33,0,681495,35000,716495,0,805523004,41290000,846813004,0,99,97,99,97,716495,98,-0.838926174496644
وصنعت,2011-02-13,1897597898,182,73,0,69,3,1565877,0,1185877,380000,1897597898,0,1435809058,461788840,101,97,97,100,1565877,101,2.53807106598985
وصنعت,2011-02-14,2390572322,178,81,3,38,2,1650516,315700,1223036,743180,2005973987,384598335,1496384215,894188107,104,99,102,100,1966216,101,0.33003300330033
وصنعت,2011-02-15,2931471336,223,106,4,27,4,2071462,410000,464919,2016543,2446121336,485350000,554797234,2376674102,100,97,99,97,2481462,98,-2.87828947368421
وصنعت,2011-02-16,8372229500,712,255,4,45,1,6315580,1030486,996066,6350000,7201528170,1170701330,1150992838,7221236662,98,94,97,94,7346066,95,-3.47163420829805
وصنعت,2011-02-19,3703876777,270,149,0,46,1,3282250,0,1382250,1900000,3703876777,0,1581658876,2122217901,97,91,96,95,3282250,94,-1.05263157894737
وصنعت,2011-02-20,1255065384,160,91,1,46,0,1091220,20000,1111220,0,1232505384,22560000,1255065384,0,95,93,95,94,1111220,94,0.088652482269504
وصنعت,2011-02-22,950903631,100,52,2,41,0,558442,282724,841166,0,629805474,321098157,950903631,0,95,92,94,95,841166,94,0.088573959255979
وصنعت,2011-02-23,2264225389,192,55,5,99,0,1088441,841676,1930117,0,1277202752,987022637,2264225389,0,97,94,94,97,1930117,97,3.80530973451327
وصنعت,2011-02-26,2433537336,235,68,2,120,0,968932,1042382,2011314,0,1169348985,1264188351,2433537336,0,101,98,100,100,2011314,100,3.15430520034101
وصنعت,2011-02-27,1991807270,207,60,5,72,1,924861,749298,1467185,206974,1101098361,890708909,1741011622,250795648,101,96,99,97,1674159,99,-1.65289256198347
وصنعت,2011-02-28,1165431564,112,55,0,49,1,1001963,0,989463,12500,1165431564,0,1150806564,14625000,98,95,97,96,1001963,96,-2.26890756302521
وصنعت,2011-03-01,5824452587,291,71,8,54,2,1271975,3808286,3810261,1270000,1455745117,4368707470,4362411928,1462040659,96,94,96,95,5080261,95,-1.46173688736028
وصنعت,2011-03-02,1373933527,95,42,1,43,0,1165496,10000,1175496,0,1362193527,11740000,1373933527,0,98,96,97,96,1175496,97,2.00698080279232
وصنعت,2011-03-05,6789011427,392,89,5,144,8,4083270,1550000,3798270,1835000,4919751630,1869259797,4564786427,2224225000,101,97,99,101,5633270,100,3.07955517536356
وصنعت,2011-03-06,3966755112,256,76,4,109,5,2244867,992753,2756799,480821,2753301337,1213453775,3378625773,588129339,103,98,103,100,3237620,102,1.6597510373444
وصنعت,2011-03-07,1546229528,136,54,3,43,4,1091472,210100,918560,383012,1296746052,249483476,1090972224,455257304,99,98,98,98,1301572,99,-3.02040816326531
وصنعت,2011-03-08,1833870518,136,53,1,41,3,1486785,50000,1394217,142568,1774270518,59600000,1662619278,171251240,101,98,99,99,1536785,99,0.420875420875421
وصنعت,2011-03-09,1305396833,146,61,2,51,2,894364,200000,797680,296684,1066096833,239300000,952002131,353394702,101,98,100,98,1094364,99,0
وصنعت,2011-03-12,1553731263,147,69,3,27,1,1205863,124600,430463,900000,1408667663,145063600,504030319,1049700944,100,96,98,96,1330463,97,-2.09555741827326
وصنعت,2011-03-13,718378144,78,40,1,31,1,611967,847,562834,49980,717399012,979132,659881544,58496600,98,96,96,96,612814,97,0.256849315068493
وصنعت,2011-03-14,1759265668,131,72,1,33,2,1442552,50000,593422,899130,1700055668,59210000,701324404,1057941264,99,97,97,97,1492552,98,0.683176771989752
وصنعت,2011-03-15,1916269843,144,48,2,71,1,1068555,532748,1551303,50000,1276000034,640269809,1856269843,60000000,101,98,99,101,1601303,99,1.52671755725191
وصنعت,2011-03-16,10179998729,1329,99,2,101,4,3552532,4846543,2661440,5737635,4378686758,5801311971,3286531635,6893467094,103,99,101,103,8399075,101,1.2531328320802
وصنعت,2011-03-19,3678049957,154,65,1,62,4,1920447,1000000,1266127,1654320,2418049957,1260000000,1593611757,2084438200,104,102,102,104,2920447,104,3.87788778877888
وصنعت,2011-03-26,966984580,52,14,0,27,2,740693,0,535693,205000,966984580,0,699839580,267145000,109,108,108,109,740693,108,3.65369340746624
وصنعت,2011-03-27,10428279800,534,204,4,153,10,6573112,1165000,5081157,2656955,8849050560,1579229240,6846025916,3582253884,113,108,112,108,7738112,112,3.29501915708812
وصنعت,2011-03-28,5532006168,437,166,3,130,2,3910103,281802,4081905,110000,5160114069,371892099,5384952332,147053836,112,107,109,110,4191905,109,-2.07715133531157
وصنعت,2011-03-29,10029474480,399,154,8,132,7,5147968,2172769,4217031,3103706,7049381058,2980093422,5771189848,4258284632,114,110,110,113,7320737,114,3.78787878787879
وصنعت,2011-03-30,9709158297,671,243,0,181,12,6974866,0,4185719,2789147,9709158297,0,5831913208,3877245089,118,111,116,115,6974866,115,1.60583941605839
وصنعت,2011-04-03,5128879423,335,130,2,115,4,3253962,416616,2558006,1112572,4544581518,584297905,3577914867,1550964556,118,115,115,115,3670578,116,0.359195402298851
وصنعت,2011-04-04,17707632359,766,312,6,173,7,11550894,682845,6326125,5907614,16722782023,984850336,9149651300,8557981059,120,117,118,120,12233739,120,3.57909806728704
وصنعت,2011-04-05,13954115127,795,359,7,163,11,8415134,938198,5898911,3454421,12546652023,1407463104,8773240834,5180874293,125,120,125,120,9353332,124,3.10988251554941
وصنعت,2011-04-06,10923039228,617,264,1,200,4,7434034,150000,6334034,1250000,10708089228,214950000,9130662402,1792376826,123,119,123,120,7584034,119,-3.48525469168901
وصنعت,2011-04-09,11373215959,628,251,7,188,4,6711967,1186858,5885002,2013823,9698325892,1674890067,8533839067,2839376892,124,115,122,115,7898825,119,0
وصنعت,2011-04-10,4787347837,380,150,2,129,3,3344666,75000,2955942,463724,4682832837,104515000,4137201545,650146292,118,115,116,115,3419666,116,-2.77777777777778
وصنعت,2011-04-11,3229618985,276,133,2,89,2,2183892,105000,2142854,146038,3080619639,148999346,3022272605,207346380,120,114,115,116,2288892,117,0.785714285714286
وصنعت,2011-04-12,7480197901,365,137,4,84,4,3023355,2333738,2521592,2835501,4220525108,3259672793,3531319883,3948878018,119,114,119,115,5357093,116,-1.06307583274274
وصنعت,2011-04-13,4332509424,307,122,3,82,4,2671017,445000,2302261,813756,3712659566,619849858,3199515541,1132993883,118,113,117,114,3116017,115,-0.429799426934097
وصنعت,2011-04-16,3632769259,307,148,2,57,1,2560714,70000,2530714,100000,3537284259,95485000,3492769259,140000000,118,113,116,113,2630714,115,-0.647482014388489
وصنعت,2011-04-17,3174573130,262,103,4,86,1,1332317,1002000,2274317,60000,1811962873,1362610257,3093262412,81310718,115,112,115,112,2334317,113,-1.52063721940623
وصنعت,2011-04-18,2307724992,249,100,2,95,0,1645093,70000,1715093,0,2213264992,94460000,2307724992,0,114,109,112,110,1715093,112,-1.02941176470588
وصنعت,2011-04-19,3403580405,302,126,5,78,3,2370574,222000,1755976,836598,3112000405,291580000,2306163254,1097417151,111,108,110,110,2592574,109,-2.4517087667162
وصنعت,2011-04-20,945458085,83,22,1,42,0,595255,100000,695255,0,808958085,136500000,945458085,0,113,110,110,113,695255,112,3.27494287890327
وصنعت,2011-04-23,3887874812,180,71,1,84,3,2558161,200000,2138161,620000,3605895312,281979500,3014101026,873773786,117,116,117,117,2758161,117,3.98230088495575
وصنعت,2011-04-24,3961852737,317,167,1,93,2,2807940,30000,2717518,120422,3921082737,40770000,3792284245,169568492,119,113,119,113,2837940,116,-0.992907801418439
وصنعت,2011-04-25,3405429514,215,110,6,49,0,1270218,1264006,2534224,0,1709486392,1695943122,3405429514,0,113,111,113,111,2534224,111,-3.72492836676218
وصنعت,2011-04-26,1675730433,163,79,1,51,2,1139175,100000,1228075,11100,1538983953,136746480,1660553633,15176800,114,110,114,112,1239175,112,0.595238095238095
وصنعت,2011-04-27,5201863967,351,180,6,73,4,2722569,1267014,2567377,1422206,3556246823,1645617144,3352803405,1849060562,113,108,112,108,3989583,108,-3.55029585798817
وصنعت,2011-04-30,343764383,33,26,1,5,0,223924,50000,273924,0,281014383,62750000,343764383,0,106,104,106,104,273924,107,-1.38036809815951
وصنعت,2011-05-01,7643394673,399,182,5,139,6,5680890,490000,4039890,2131000,7036024673,607370000,5007004074,2636390599,106,102,102,106,6170890,103,-3.6547433903577
وصنعت,2011-05-02,214057872,11,4,0,10,0,166194,0,166194,0,214057872,0,214057872,0,107,107,107,107,166194,104,0.887812752219532
وصنعت,2011-05-03,11160680150,520,293,4,81,4,8287034,417794,4286234,4418594,10620879856,539800294,5548179591,5612500559,108,103,108,108,8704828,106,2.56
وصنعت,2011-05-04,3441301058,260,99,2,113,1,2152291,450000,2592291,10000,2841607856,599693202,3427971058,13330000,111,106,108,111,2602291,110,3.1201248049922
وصنعت,2011-05-08,3508835418,252,126,3,87,1,2388223,354700,2737923,5000,3058266418,450569000,3502435418,6400000,110,105,110,105,2742923,106,-3.25264750378215
وصنعت,2011-05-09,2729735760,250,96,1,84,2,1907353,150000,1981795,75558,2530587930,199147830,2629386620,100349140,110,108,109,110,2057353,110,3.7529319781079
وصنعت,2011-05-10,3321052805,285,147,5,61,2,2098153,470000,1359153,1209000,2715967945,605084860,1768384465,1552668340,113,106,113,106,2568153,107,-2.5621703089676
وصنعت,2011-05-11,3219590638,207,57,3,93,4,846093,1653000,2150548,348545,1080993231,2138597407,2768858000,450732638,111,104,108,106,2499093,107,-0.386697602474865
وصنعت,2011-05-14,358729283,23,7,1,14,0,152794,123367,276161,0,199385246,159344037,358729283,0,109,106,106,108,276161,107,0.31055900621118
وصنعت,2011-05-15,8628278752,417,37,2,205,3,1933006,4500000,6033006,400000,2594229880,6034048872,8091128752,537150000,111,108,108,111,6433006,111,3.79256965944272
وصنعت,2011-05-16,2705639557,250,53,1,118,2,1364891,638291,1905182,98000,1851667636,853971921,2573100761,132538796,114,109,114,112,2003182,112,0.745712155108128
وصنعت,2011-05-17,7326920665,375,75,2,191,7,3672008,1637900,3754221,1555687,5076011284,2250909381,5192641902,2134278763,117,110,110,114,5309908,114,2.14655810510733
وصنعت,2011-05-18,5696209560,336,106,2,114,7,2397709,1707000,2503295,1601414,3321466144,2374743416,3465143524,2231066036,117,112,116,113,4104709,115,0.579710144927536
وصنعت,2011-05-21,3748475965,227,37,6,108,4,622183,2112763,2158952,575994,852719546,2895756419,2957781469,790694496,115,112,112,114,2734946,114,-1.22478386167147
وصنعت,2011-05-22,3212784898,164,39,2,88,1,1296005,1075997,2272002,100000,1757021712,1455763186,3078088078,134696820,115,111,115,111,2372002,112,-1.2399708242159
وصنعت,2011-05-23,4393104434,194,27,3,74,3,657122,2596288,1709248,1544162,887479461,3505624973,2308297790,2084806644,113,111,111,113,3253410,112,-0.295420974889217
وصنعت,2011-05-24,3741987714,212,47,2,83,1,809413,2000906,2410319,400000,1068808006,2673179708,3203183717,538803997,113,107,111,107,2810319,110,-1.33333333333333
وصنعت,2011-05-25,5478258337,256,71,8,88,1,1457196,2822560,2779756,1500000,1865808958,3612449379,3559758337,1918500000,108,106,108,106,4279756,106,-3.9039039039039
وصنعت,2011-05-28,1820324838,142,50,2,76,2,734573,700000,1300848,133725,924258652,896066186,1649003204,171321634,110,102,103,103,1434573,105,-0.859375
وصنعت,2011-05-29,2637395846,124,27,2,66,0,360269,1800000,2160269,0,440447846,2196948000,2637395846,0,102,101,102,101,2160269,101,-3.78250591016548
وصنعت,2011-05-30,868832495,51,14,2,37,1,509424,181414,490838,200000,638721730,230110765,615032495,253800000,105,98,98,105,690838,104,2.78460278460278
وصنعت,2011-05-31,978750000,25,10,1,11,1,650000,100000,78104,671896,848250000,130500000,101925720,876824280,108,108,108,108,750000,108,3.98406374501992
وصنعت,2011-06-01,6797859220,333,77,2,92,8,1572719,3466495,2500895,2538319,2113560758,4684298462,3370091658,3427767562,112,109,112,111,5039214,112,3.37164750957854
وصنعت,2011-06-06,4229732162,188,60,3,69,4,1239616,1836884,2218516,857984,1692643745,2537088417,3058633384,1171098778,116,111,111,113,3076500,114,1.92735359525575
وصنعت,2011-06-07,1713324230,105,34,2,49,3,516413,750000,1062835,203578,695126826,1018197404,1434541416,278782814,115,110,115,111,1266413,112,-1.6
وصنعت,2011-06-08,5947132522,285,47,1,150,3,818939,3500000,4002517,316422,1111138114,4835994408,5507597272,439535250,116,109,109,113,4318939,114,1.77383592017738
وصنعت,2011-06-11,1445485605,118,57,2,45,0,966278,117075,1083353,0,1289401455,156084150,1445485605,0,115,110,115,110,1083353,111,-3.12273057371097
وصنعت,2011-06-12,949356665,92,49,2,24,0,476862,250000,726862,0,623356665,326000000,949356665,0,110,107,110,108,726862,108,-2.023988005997
وصنعت,2011-06-13,3090316914,147,58,1,30,2,1396282,1000000,1476282,920000,1789924883,1300392031,1907354911,1182962003,109,105,108,105,2396282,107,-1.30068859984698
وصنعت,2011-06-14,400429651,48,28,2,24,0,213242,100000,313242,0,273264651,127165000,400429651,0,108,105,108,105,313242,107,-0.387596899224806
وصنعت,2011-06-15,685439320,73,36,1,29,0,520932,19144,540076,0,661278160,24161160,685439320,0,108,104,104,106,540076,106,-0.856031128404669
وصنعت,2011-06-18,3497090660,233,62,1,73,0,1793745,859379,2653124,0,2364208282,1132882378,3497090660,0,110,108,108,110,2653124,109,3.45368916797488
وصنعت,2011-06-19,8294223534,287,45,1,125,5,843941,5300000,4140399,2003542,1139981726,7154241808,5589285658,2704937876,113,110,110,112,6143941,112,2.42792109256449
وصنعت,2011-06-20,13313604185,193,52,1,89,3,808777,8944369,1861488,7891658,1100497494,12213106691,2525632627,10787971558,114,110,110,112,9753146,113,1.11111111111111
وصنعت,2011-06-21,1232904646,95,50,3,24,2,735141,190001,451161,473981,982103286,250801360,604725479,628179167,113,109,111,110,925142,111,-2.34432234432234
وصنعت,2011-06-22,990935717,103,49,2,29,0,727746,31750,759496,0,949815467,41120250,990935717,0,111,107,110,108,759496,108,-2.10052513128282
وصنعت,2011-06-25,409103808,64,29,0,20,0,315932,0,315932,0,409103808,0,409103808,0,109,106,107,107,315932,108,-0.306513409961686
وصنعت,2011-06-26,2828178151,264,104,4,51,1,1756506,503080,1859586,400000,2199335537,628842614,2328279999,499898152,107,104,107,104,2259586,104,-3.7663335895465
وصنعت,2011-06-27,983769169,76,38,2,21,1,414798,400000,699514,115284,502969169,480800000,845197801,138571368,104,100,104,100,814798,100,-3.59424920127795
وصنعت,2011-06-28,1458269514,140,53,1,61,0,749484,450000,1199484,0,914131524,544137990,1458269514,0,103,97,97,100,1199484,101,0.745650372825186
وصنعت,2011-06-29,1593755649,124,63,0,41,1,1276715,0,526081,750634,1593755649,0,662093157,931662492,105,102,102,105,1276715,103,2.63157894736842
وصنعت,2011-07-02,697514593,87,43,0,33,0,548008,0,548008,0,697514593,0,697514593,0,107,105,105,106,548008,105,1.44230769230769
وصنعت,2011-07-03,636015457,77,44,0,26,2,516294,0,387996,128298,636015457,0,478683020,157332437,106,101,106,101,516294,103,-1.81674565560822
وصنعت,2011-07-04,229471389,35,16,0,15,0,186657,0,186657,0,229471389,0,229471389,0,104,101,102,103,186657,103,-0.241351568785197
وصنعت,2011-07-05,1404965519,170,54,1,57,3,912006,200000,786936,325070,1149769909,255195610,995529834,409435685,107,103,104,103,1112006,105,1.85483870967742
وصنعت,2011-07-06,812323120,100,42,1,39,2,343204,300000,481619,161585,431907815,380415305,608207728,204115392,106,103,105,104,643204,105,0
وصنعت,2011-07-09,909261438,122,61,1,28,1,731988,12000,693988,50000,894466638,14794800,847244030,62017408,103,101,103,101,743988,101,-3.24623911322249
وصنعت,2011-07-10,1301368772,164,47,1,54,0,593035,500000,1093035,0,701372524,599996248,1301368772,0,101,98,101,98,1093035,99,-2.53682487725041
وصنعت,2011-07-11,605648475,65,25,1,31,0,501488,5000,506488,0,599698475,5950000,605648475,0,100,99,100,99,506488,99,0.251889168765743
وصنعت,2011-07-12,579043925,77,29,1,34,0,478564,10000,488564,0,567233925,11810000,579043925,0,100,97,99,97,488564,99,-0.50251256281407
وصنعت,2011-07-13,1159100036,86,44,2,29,1,286357,705000,981357,10000,334733787,824366249,1147400036,11700000,99,96,99,97,991357,97,-1.5993265993266
وصنعت,2011-07-16,665319810,96,42,2,31,0,467138,102500,569638,0,545711903,119607907,665319810,0,98,95,96,97,569638,97,-0.085543199315654
وصنعت,2011-07-18,471503867,64,31,0,18,2,399622,0,155481,244141,471503867,0,184419324,287084543,99,97,97,98,399622,97,0.513698630136986
وصنعت,2011-07-19,771142123,82,38,0,30,1,654442,0,586998,67444,771142123,0,692917403,78224720,100,96,100,97,654442,98,0.340715502555366
وصنعت,2011-07-20,761817880,108,62,2,17,0,614055,40000,654055,0,715297880,46520000,761817880,0,98,96,97,97,654055,97,-1.01867572156197
وصنعت,2011-07-23,2396815558,212,77,0,62,5,1982797,0,1141047,841750,2396815558,0,1378998818,1017816740,101,99,99,100,1982797,100,3.68782161234991
وصنعت,2011-07-24,1849011877,109,32,1,58,3,973306,502937,1061243,415000,1218035570,630976307,1327356877,521655000,104,101,101,104,1476243,104,3.63937138130687
وصنعت,2011-07-25,1097119637,125,63,1,37,0,892857,10000,902857,0,1085079637,12040000,1097119637,0,105,100,105,100,902857,101,-3.03272146847566
وصنعت,2011-07-26,955405575,82,34,0,29,1,796287,0,346287,450000,955405575,0,416977173,538428402,101,98,101,99,796287,100,-1.23456790123457
وصنعت,2011-07-27,774276756,111,38,0,26,0,649984,0,649984,0,774276756,0,774276756,0,100,98,100,99,649984,99,-0.666666666666667
وصنعت,2011-07-30,673585876,90,48,2,19,0,559838,15000,574838,0,656030876,17555000,673585876,0,100,96,99,96,574838,98,-1.25838926174497
وصنعت,2011-07-31,633339174,80,37,1,26,0,534842,10000,544842,0,621739174,11600000,633339174,0,97,96,96,96,544842,97,-0.934579439252336
وصنعت,2011-08-01,869840549,116,54,0,28,0,739821,0,739821,0,869840549,0,869840549,0,99,97,99,98,739821,98,0.857632933104631
وصنعت,2011-08-02,474881472,56,24,0,23,0,402601,0,402601,0,474881472,0,474881472,0,99,97,99,98,402601,98,0.170068027210884
وصنعت,2011-08-03,1070424408,102,34,0,32,1,907064,0,707064,200000,1070424408,0,834809413,235614995,98,97,98,98,907064,98,0.169779286926995
وصنعت,2011-08-06,1086290635,143,78,1,32,0,938164,10000,948164,0,1074790635,11500000,1086290635,0,97,95,97,95,948164,95,-2.88135593220339
وصنعت,2011-08-07,896696471,165,79,0,29,1,791035,0,546303,244732,896696471,0,620516262,276180209,95,93,94,94,791035,94,-1.04712041884817
وصنعت,2011-08-08,795758150,102,34,1,27,1,682299,10000,392299,300000,784248150,11510000,450458150,345300000,96,94,94,96,692299,95,1.23456790123457
وصنعت,2011-08-09,3536088238,236,91,5,48,1,2280834,909786,3190619,1,2529099710,1006988528,3536087118,1120,95,91,95,94,3190620,92,-3.48432055749129
وصنعت,2011-08-10,880392049,103,52,0,40,0,770826,0,770826,0,880392049,0,880392049,0,95,93,95,95,770826,95,3.06859205776173
وصنعت,2011-08-13,1188512255,104,22,0,58,3,1012616,0,954116,58500,1188512255,0,1119317755,69194500,98,95,95,98,1012616,97,2.80210157618214
وصنعت,2011-08-14,3128849648,173,53,2,86,3,2483890,94758,2458648,120000,3016476176,112373472,2982549648,146300000,101,98,101,99,2578648,101,3.32197614991482
وصنعت,2011-08-15,539058957,67,25,0,33,0,457092,0,457092,0,539058957,0,539058957,0,99,97,97,98,457092,99,-1.73124484748557
وصنعت,2011-08-16,1316271068,135,32,1,75,1,1050180,50000,1025422,74758,1256021068,60250000,1226187678,90083390,101,97,99,100,1100180,99,0.335570469798658
وصنعت,2011-08-17,1606158124,139,23,2,80,0,231555,1111336,1342891,0,274938094,1331220030,1606158124,0,100,97,99,100,1342891,99,0
وصنعت,2011-08-20,466522235,69,38,1,26,0,391945,10000,401945,0,454952235,11570000,466522235,0,98,96,96,96,401945,98,-1.58862876254181
وصنعت,2011-08-21,514766252,62,20,2,36,0,227202,210000,437202,0,265361083,249405169,514766252,0,100,96,97,97,437202,98,0
وصنعت,2011-08-23,1193840251,95,36,1,37,1,862823,150000,1002823,10000,1016156979,177683272,1181980251,11860000,99,96,96,97,1012823,98,0.169923534409516
وصنعت,2011-08-24,605301150,67,36,1,24,0,507026,10000,517026,0,593661150,11640000,605301150,0,99,96,98,96,517026,97,-0.508905852417303
وصنعت,2011-08-27,1217406743,97,23,2,57,0,227698,800000,1027698,0,265508460,951898283,1217406743,0,100,96,97,98,1027698,98,1.0230179028133
وصنعت,2011-08-28,735605127,98,43,2,26,0,571469,67268,638737,0,658765071,76840056,735605127,0,97,95,96,96,638737,96,-2.36286919831224
وصنعت,2011-08-29,971751710,91,50,0,26,0,837970,0,837970,0,971751710,0,971751710,0,97,95,96,96,837970,96,0.259291270527226
وصنعت,2011-08-30,693005993,91,30,0,34,0,591159,0,591159,0,693005993,0,693005993,0,99,96,98,97,591159,97,0.862068965517241
وصنعت,2011-09-03,1622433321,138,64,0,16,1,1406396,0,266241,1140155,1622433321,0,310791908,1311641413,98,95,97,96,1406396,96,-1.36752136752137
وصنعت,2011-09-04,590008004,91,43,3,30,0,414903,93801,508704,0,480692445,109315559,590008004,0,97,95,97,96,508704,96,0.346620450606586
وصنعت,2011-09-05,1116496608,89,30,2,40,0,780325,176199,956524,0,910354992,206141616,1116496608,0,97,96,96,96,956524,97,0.77720207253886
وصنعت,2011-09-06,4114775611,244,58,1,109,3,3003866,400000,2423866,980000,3633801732,480973879,2927135611,1187640000,101,98,99,101,3403866,100,3.59897172236504
وصنعت,2011-09-07,5439321690,303,101,4,122,1,3292997,1122438,4299435,116000,4042550182,1396771508,5294437690,144884000,104,99,104,103,4415435,102,1.90239867659223
وصنعت,2011-09-10,2639899103,211,53,4,91,1,1265616,850000,2102616,13000,1578599293,1061299810,2623773940,16125163,105,102,102,102,2115616,103,1.2987012987013
وصنعت,2011-09-11,2324094495,197,51,2,109,1,1290065,540000,1820065,10000,1628374495,695720000,2311422815,12671680,107,104,107,104,1830065,105,1.76282051282051
وصنعت,2011-09-12,1693248711,130,47,2,57,1,1329992,40000,1119992,250000,1643771725,49476986,1385090577,308158134,104,102,104,103,1369992,102,-2.67716535433071
وصنعت,2011-09-13,1231589458,79,31,1,37,0,953797,50000,1003797,0,1170339458,61250000,1231589458,0,103,101,103,101,1003797,102,-0.728155339805825
وصنعت,2011-09-14,1909840407,166,55,2,55,2,1455347,86540,1375449,166438,1803457872,106382535,1703106505,206733902,104,101,103,101,1541887,103,0.97799511002445
وصنعت,2011-09-17,1013074338,103,34,1,34,0,826287,8600,834887,0,1002685538,10388800,1013074338,0,102,100,101,101,834887,101,-2.09846650524617
وصنعت,2011-09-18,935870337,114,25,1,37,1,766463,1400,752853,15010,934176337,1694000,917507907,18362430,102,100,100,102,767863,101,0.494641384995878
وصنعت,2011-09-19,902002728,87,32,1,30,2,702545,40000,640175,102370,853522728,48480000,776687628,125315100,102,100,102,100,742545,101,-0.328137817883511
وصنعت,2011-09-20,438556818,54,15,3,21,2,207965,155356,332571,30750,251371538,187185280,401368325,37188493,101,100,100,100,363321,100,-0.329218106995885
وصنعت,2011-09-21,951035571,96,39,1,24,1,752334,29248,732712,48870,915585743,35449828,891618521,59417050,102,100,100,101,781582,101,0.495458298926507
وصنعت,2011-09-25,823138746,60,20,2,30,0,557007,129634,686641,0,668157482,154981264,823138746,0,100,99,100,99,686641,100,-1.39687756778965
وصنعت,2011-09-26,890678565,88,16,1,35,0,216033,530000,746033,0,257560050,633118515,890678565,0,100,98,100,99,746033,99,-0.5
وصنعت,2011-09-27,494591024,62,22,1,24,1,376597,35282,381879,30000,452252624,42338400,458531024,36060000,100,99,100,100,411879,99,0.33500837520938
وصنعت,2011-09-28,534269393,50,10,8,26,0,160426,281780,442206,0,194023970,340245423,534269393,0,101,99,99,101,442206,100,0.500834724540901
وصنعت,2011-10-01,568887196,92,17,4,30,0,88730,384750,473480,0,106429480,462457716,568887196,0,101,99,99,100,473480,100,-0.166112956810631
وصنعت,2011-10-02,2130368499,169,20,5,48,3,539123,1209089,869184,879028,656485548,1473882951,1058184912,1072183587,103,100,100,101,1748212,101,1.41430948419301
وصنعت,2011-10-03,2946620475,213,31,5,86,4,1257649,1097874,1534923,820600,1567219617,1379400858,1929836844,1016783631,105,101,101,105,2355523,104,2.62510254306809
وصنعت,2011-10-04,9064626276,575,136,1,207,8,6663902,372000,5946580,1089322,8586775903,477850373,7667813861,1396812415,108,105,106,108,7035902,107,2.95763389288569
وصنعت,2011-10-05,3262807517,276,68,1,93,1,2490740,13514,2004254,500000,3245577167,17230350,2610105652,652701865,109,106,108,106,2504254,108,1.16459627329193
وصنعت,2011-10-08,1652296494,149,21,2,64,1,441633,843772,885405,400000,572435084,1079861410,1140295094,512001400,109,106,108,106,1285405,107,-1.38142747505756
وصنعت,2011-10-09,1890725463,158,28,4,66,0,334305,1150000,1484305,0,425435612,1465289851,1890725463,0,106,104,106,105,1484305,106,-0.856031128404669
وصنعت,2011-10-10,1471731905,149,40,3,46,0,945894,208248,1154142,0,1206345285,265386620,1471731905,0,107,105,105,106,1154142,106,0.078492935635793
وصنعت,2011-10-11,8509398433,404,94,2,125,4,5931820,500000,5778748,653072,7850132743,659265690,7650097885,859300548,110,107,107,110,6431820,110,3.76470588235294
وصنعت,2011-10-12,13076671448,599,91,9,201,15,4883454,4823063,7144306,2562211,6571450502,6505220946,9624317476,3452353972,114,108,109,111,9706517,112,1.8140589569161
وصنعت,2011-10-15,5659393031,363,104,2,95,1,4160715,157800,4018515,300000,5455149831,204243200,5264745491,394647540,113,107,113,110,4318515,109,-2.74684484038604
وصنعت,2011-10-16,5240423357,418,129,5,105,4,2885760,1095242,2823232,1157770,3804778866,1435644491,3727294766,1513128591,112,106,112,109,3981002,109,0.458015267175573
وصنعت,2011-10-17,6696398594,466,147,2,113,9,4392051,550000,3288690,1653361,5945650270,750748324,4458162610,2238235984,113,109,109,112,4942051,112,2.96352583586626
وصنعت,2011-10-18,2835954328,288,109,1,67,2,2035388,75000,2003348,107040,2734829328,101125000,2691450328,144504000,112,110,112,110,2110388,111,-0.811808118081181
وصنعت,2011-10-19,1070924501,158,57,1,30,2,610197,200000,779989,30208,806934501,263990000,1030973882,39950619,111,109,111,109,810197,110,-1.63690476190476
وصنعت,2011-10-22,865696595,109,50,2,32,0,639900,25000,664900,0,832945196,32751399,865696595,0,109,107,109,107,664900,108,-1.36157337367625
وصنعت,2011-10-23,1402910287,140,44,2,48,0,839167,230885,1070052,0,1101436341,301473946,1402910287,0,109,107,108,109,1070052,109,0.53680981595092
وصنعت,2011-10-24,1834001487,128,49,1,39,0,707223,730000,1437223,0,901931487,932070000,1834001487,0,110,105,110,106,1437223,106,-2.6697177726926
وصنعت,2011-10-25,2162274708,142,47,2,30,1,711875,963929,325804,1350000,916813722,1245460986,420447178,1741827530,108,106,107,107,1675804,107,1.09717868338558
وصنعت,2011-10-26,1037565026,83,36,2,27,1,619475,190000,789475,20000,794665026,242900000,1011716639,25848387,109,106,109,106,809475,106,-0.62015503875969
وصنعت,2011-10-29,1907179118,152,50,2,35,1,871213,632000,1428213,75000,1104948238,802230880,1812079118,95100000,106,104,106,104,1503213,105,-1.01404056162246
وصنعت,2011-10-30,661881452,78,27,1,27,0,494058,30000,524058,0,623921452,37960000,661881452,0,106,103,104,105,524058,105,-0.315208825847124
وصنعت,2011-10-31,322745788,45,25,2,13,1,249575,4361,253403,533,317278373,5467415,322063548,682240,106,104,104,105,253936,105,0.158102766798419
وصنعت,2011-11-01,381930905,59,29,1,28,0,280230,18419,298649,0,358483518,23447387,381930905,0,107,104,104,107,298649,105,0.394632991318074
وصنعت,2011-11-02,779320599,92,45,0,29,1,602281,0,584481,17800,779320599,0,755918154,23402445,109,106,108,106,602281,107,1.41509433962264
وصنعت,2011-11-05,744128879,71,32,3,25,0,504824,80151,584975,0,640568568,103560311,744128879,0,108,104,108,105,584975,106,-1.08527131782946
وصنعت,2011-11-06,3216735588,270,69,5,52,0,1190629,1416305,2606934,0,1470425722,1746309866,3216735588,0,105,102,105,102,2606934,102,-3.29153605015674
وصنعت,2011-11-08,1366298190,134,43,4,51,0,558055,583840,1141895,0,668701684,697596506,1366298190,0,101,99,101,99,1141895,99,-2.99837925445705
وصنعت,2011-11-09,1337772144,108,29,2,37,0,594878,486557,1081435,0,734818536,602953608,1337772144,0,103,99,99,103,1081435,103,3.34168755221387
وصنعت,2011-11-12,706509098,85,38,1,20,1,559601,8000,517601,50000,696501098,10008000,644873026,61636072,104,101,104,101,567601,103,0.485044462409054
وصنعت,2011-11-13,690402922,102,40,0,31,0,570843,0,570843,0,690402922,0,690402922,0,102,100,101,100,570843,101,-2.09171359613837
وصنعت,2011-11-14,45294260,24,9,1,13,0,35091,2250,37341,0,42583010,2711250,45294260,0,102,100,101,100,37341,101,0
وصنعت,2011-11-16,754951489,51,24,2,16,0,455763,167750,623513,0,551989209,202962280,754951489,0,103,100,101,100,623513,101,-0.410846343467543
وصنعت,2011-11-19,925737349,79,32,1,26,0,705569,53921,759490,0,860242939,65494410,925737349,0,102,100,102,101,759490,101,0.577557755775578
وصنعت,2011-11-20,1312426132,136,69,2,35,0,948235,150000,1098235,0,1133906132,178520000,1312426132,0,101,99,100,100,1098235,99,-1.96882690730107
وصنعت,2011-11-21,768794491,98,40,0,26,0,641663,0,641663,0,768794491,0,768794491,0,101,98,100,100,641663,99,0.251046025104602
وصنعت,2011-11-22,2058142802,186,92,3,41,0,1453522,320000,1773522,0,1689812802,368330000,2058142802,0,100,95,100,95,1773522,96,-3.17195325542571
وصنعت,2011-11-23,353766519,75,34,0,32,1,308915,0,306095,2820,353766519,0,350537619,3228900,96,94,94,95,308915,96,-0.517241379310345
وصنعت,2011-11-26,269300730,39,15,1,21,0,134036,100000,234036,0,154100730,115200000,269300730,0,96,95,95,95,234036,96,-0.086655112651647
وصنعت,2011-11-27,1117290735,123,48,2,37,1,680479,320000,880479,120000,760109468,357181267,982050735,135240000,95,92,95,92,1000479,93,-3.12228967909801
وصنعت,2011-11-28,1277863316,209,71,2,38,2,1073801,110000,625801,558000,1159208316,118655000,677068986,600794330,91,89,90,89,1183801,89,-3.40196956132498
وصنعت,2011-11-29,399911338,40,14,1,20,0,213016,144000,357016,0,238647638,161263700,399911338,0,93,91,91,93,357016,91,1.85356811862836
وصنعت,2011-11-30,1121685980,139,55,2,33,2,977970,32030,965462,44538,1086376131,35309849,1073035636,48650344,93,90,93,93,1010000,92,1.0919017288444
وصنعت,2011-12-03,914861402,108,45,1,22,0,797566,13993,811559,0,899153355,15708047,914861402,0,95,91,92,95,811559,93,1.44014401440144
وصنعت,2011-12-04,694653864,64,27,1,26,0,556787,36850,593637,0,651487214,43166650,694653864,0,97,96,96,97,593637,96,3.01685891748004
وصنعت,2011-12-07,3033083357,264,96,1,35,6,2320488,200000,1079987,1440501,2791683357,241400000,1298773599,1734309758,100,97,100,100,2520488,100,3.61757105943152
وصنعت,2011-12-10,953651048,148,64,0,44,0,806073,0,806073,0,953651048,0,953651048,0,103,96,103,97,806073,98,-1.66251039068994
وصنعت,2011-12-11,422750290,70,30,0,29,0,363797,0,363797,0,422750290,0,422750290,0,100,96,100,99,363797,97,-0.84530853761623
وصنعت,2011-12-12,522368339,68,22,1,31,2,138945,300000,402813,36132,164634459,357733880,479125449,43242890,100,97,99,99,438945,98,0.852514919011083
وصنعت,2011-12-13,709552451,102,26,0,44,0,588077,0,588077,0,709552451,0,709552451,0,101,98,98,98,588077,100,1.52155536770921
وصنعت,2011-12-14,554942853,93,26,0,33,1,469623,0,449623,20000,554942853,0,531342853,23600000,99,97,98,98,469623,99,-0.999167360532889
وصنعت,2011-12-17,430407335,74,24,0,24,0,370527,0,370527,0,430407335,0,430407335,0,97,96,96,96,370527,97,-1.17746005046257
وصنعت,2011-12-18,1228970148,106,37,0,54,0,1024716,0,1024716,0,1228970148,0,1228970148,0,101,98,98,101,1024716,99,2.04255319148936
وصنعت,2011-12-19,911596101,100,37,0,28,1,761846,0,756846,5000,911596101,0,905521101,6075000,101,98,101,98,761846,99,-0.166805671392827
وصنعت,2011-12-20,952932460,123,61,0,24,0,815441,0,815441,0,952932460,0,952932460,0,100,96,100,97,815441,97,-2.33918128654971
وصنعت,2011-12-21,1037800321,101,39,1,22,0,892848,5000,897848,0,1032010321,5790000,1037800321,0,96,95,96,95,897848,96,-1.11206159110351
وصنعت,2011-12-24,585271164,62,29,1,24,0,482851,15000,497851,0,567496164,17775000,585271164,0,99,96,96,97,497851,97,1.12456747404844
وصنعت,2011-12-25,950812632,87,46,1,20,0,812805,5000,817805,0,945032632,5780000,950812632,0,99,95,96,96,817805,96,-0.513259195893926
وصنعت,2011-12-26,629250320,79,24,0,25,1,541451,0,380125,161326,629250320,0,441422942,187827378,97,96,96,96,541451,96,-0.085984522785899
وصنعت,2011-12-27,574973580,65,24,0,33,1,496912,0,484180,12732,574973580,0,560191728,14781852,97,95,97,96,496912,96,-0.258175559380379
وصنعت,2011-12-28,658582889,83,36,1,21,2,556509,12578,348145,220942,644047455,14535434,403276111,255306778,99,95,99,97,569087,96,-0.086281276962899
وصنعت,2011-12-31,734773159,65,24,1,29,0,624362,422,624784,0,734277309,495850,734773159,0,98,97,97,98,624784,97,1.29533678756477
وصنعت,2012-01-01,975622640,96,24,1,55,0,800985,25010,825995,0,945980800,29641840,975622640,0,100,96,96,100,825995,98,0.682011935208866
وصنعت,2012-01-02,1379268348,89,37,0,29,3,1155792,0,714854,440938,1379268348,0,853082961,526185387,99,98,99,99,1155792,99,1.01608806096528
وصنعت,2012-01-03,1001881937,119,36,1,53,1,794517,30000,814517,10000,965913661,35968276,989681937,12200000,102,99,99,100,824517,101,1.84409052808047
وصنعت,2012-01-04,904913573,79,32,0,31,1,738604,0,728604,10000,904913573,0,892623573,12290000,103,100,100,101,738604,102,0.823045267489712
وصنعت,2012-01-07,86398861538,187,67,2,58,1,1659430,70300000,1640666,70318764,2029591568,84369269970,2011139742,84387721796,103,100,102,101,71959430,100,-1.95918367346939
وصنعت,2012-01-08,1926672782,206,82,1,37,2,1510154,54869,658194,906829,1858964436,67708346,811159013,1115513769,103,101,103,102,1565023,102,2.49791840133222
وصنعت,2012-01-09,2944758301,119,21,3,57,2,706899,1597467,884366,1420000,900009041,2044749260,1127158301,1817600000,106,103,103,106,2304366,106,3.81803411860276
وصنعت,2012-01-10,3431233580,294,101,0,86,4,2660590,0,2112083,548507,3431233580,0,2723388423,707845157,108,105,108,106,2660590,107,0.938967136150235
وصنعت,2012-01-11,1528512795,169,54,0,72,1,1182671,0,1172671,10000,1528512795,0,1515502795,13010000,109,105,106,105,1182671,107,0.155038759689922
وصنعت,2012-01-15,1893738923,171,53,1,66,0,682478,803000,1485478,0,869088961,1024649962,1893738923,0,106,104,106,105,1485478,106,-1.31578947368421
وصنعت,2012-01-16,2210894336,183,48,2,61,2,1122055,609000,1135255,595800,1433910285,776984051,1450759005,760135331,107,104,104,106,1731055,106,0.156862745098039
وصنعت,2012-01-17,8564306591,464,95,3,179,4,3085464,3500000,5867464,718000,3971319039,4592987552,7619469193,944837398,110,104,105,107,6585464,108,1.80109631949883
وصنعت,2012-01-25,13680541111,686,85,6,208,6,3670894,8334584,10671068,1334410,4121918834,9558622277,12150296011,1530245100,111,107,107,111,12005478,110,1.78571428571429
وصنعت,2012-01-28,6917798008,540,59,3,125,4,625240,5300000,3926937,1998303,717862863,6199935145,4556332389,2361465619,114,108,111,111,5925240,112,2.45614035087719
وصنعت,2012-01-31,5094904983,358,23,1,62,2,217080,4125486,2830869,1511697,249904820,4845000163,3318661008,1776243975,114,108,108,110,4342566,113,0.428082191780822
وصنعت,2012-02-01,403148636,86,42,0,30,0,355671,0,355671,0,403148636,0,403148636,0,110,109,109,109,355671,111,-1.61977834612106
وصنعت,2012-02-04,1532075310,173,86,1,41,0,1290919,80510,1371429,0,1442870230,89205080,1532075310,0,111,107,109,107,1371429,108,-3.20623916811092
وصنعت,2012-02-05,1145288197,153,79,3,35,0,877289,184935,1062224,0,946218428,199069769,1145288197,0,107,103,107,103,1062224,104,-3.49149507609669
وصنعت,2012-02-06,956234620,116,48,2,28,0,442778,458588,901366,0,469371213,486863407,956234620,0,103,101,103,103,901366,102,-1.57699443413729
وصنعت,2012-02-07,231028060,41,24,0,14,0,217418,0,217418,0,231028060,0,231028060,0,103,102,102,102,217418,102,0
وصنعت,2012-02-08,509335803,108,40,1,40,0,371871,100000,471871,0,400089143,109246660,509335803,0,106,103,106,103,471871,103,1.13100848256362
وصنعت,2012-02-12,354194706,64,31,1,22,0,272782,58447,331229,0,291545401,62649305,354194706,0,104,102,103,103,331229,103,-0.186393289841566
وصنعت,2012-02-13,481606392,67,28,1,32,0,349426,91553,440979,0,381198986,100407406,481606392,0,106,104,105,104,440979,104,1.12044817927171
وصنعت,2012-02-14,605179640,98,45,1,26,0,510869,65000,575869,0,537551640,67628000,605179640,0,103,100,103,100,575869,102,-2.3084025854109
وصنعت,2012-02-15,657401336,94,55,1,25,0,538035,100000,638035,0,554401336,103000000,657401336,0,101,98,98,99,638035,100,-2.26843100189036
وصنعت,2012-02-18,285205839,55,24,0,28,0,275151,0,275151,0,285205839,0,285205839,0,102,99,100,99,275151,100,0.096711798839459
وصنعت,2012-02-19,567669065,91,44,0,29,0,555574,0,555574,0,567669065,0,567669065,0,99,97,98,99,555574,99,-0.966183574879227
وصنعت,2012-02-20,358696548,74,28,2,33,0,264363,82000,346363,0,273230248,85466300,358696548,0,101,98,98,100,346363,99,0.487804878048781
وصنعت,2012-02-21,1610577686,167,63,1,55,0,1141082,375324,1516406,0,1211658226,398919460,1610577686,0,103,100,100,103,1516406,102,3.10679611650485
وصنعت,2012-02-22,463925648,65,30,1,24,1,339932,100000,419932,20000,358925648,105000000,442805648,21120000,106,100,106,101,439932,102,-0.376647834274953
وصنعت,2012-02-25,1313389011,110,57,0,24,0,1275506,0,1275506,0,1313389011,0,1313389011,0,101,98,100,98,1275506,99,-2.64650283553875
وصنعت,2012-02-26,750100159,101,44,0,31,0,732940,0,732940,0,750100159,0,750100159,0,101,98,99,99,732940,99,-0.58252427184466
وصنعت,2012-02-27,1216652453,115,44,1,33,1,670164,500000,1158164,12000,692003060,524649393,1204190063,12462390,101,98,100,98,1170164,100,1.5625
وصنعت,2012-02-28,705721730,106,45,0,26,0,676113,0,676113,0,705721730,0,705721730,0,102,99,100,102,676113,100,0.288461538461538
وصنعت,2012-02-29,1867271514,170,54,1,89,1,1534785,200000,1714685,20100,1650492702,216778812,1845864514,21407000,104,99,102,103,1734785,104,3.16395014381592
وصنعت,2012-03-03,1196942810,170,66,1,27,1,981145,150000,1021145,110000,1039726402,157216408,1079694069,117248741,106,100,103,101,1131145,102,-1.6728624535316
وصنعت,2012-03-04,2067581814,111,24,1,62,2,1789662,100000,1379662,510000,1959581814,108000000,1508591814,558990000,106,102,104,106,1889662,105,3.40264650283554
وصنعت,2012-03-05,1565028245,120,55,1,45,5,1181055,250000,974055,457000,1289458245,275570000,1067189158,497839087,108,103,108,104,1431055,105,0
وصنعت,2012-03-06,6514325033,162,61,1,22,2,678424,5323314,646365,5355373,717289343,5797035690,683947036,5830377997,105,101,101,103,6001738,104,-0.822669104204753
وصنعت,2012-03-07,625851559,94,40,0,31,0,583973,0,583973,0,625851559,0,625851559,0,104,102,103,103,583973,103,-0.921658986175115
وصنعت,2012-03-10,746585869,83,25,0,38,1,697091,0,667191,29900,746585869,0,714580479,32005390,104,103,103,103,697091,103,-0.372093023255814
وصنعت,2012-03-11,891400591,127,52,0,38,0,844642,0,844642,0,891400591,0,891400591,0,103,101,102,101,844642,102,-1.49393090569561
وصنعت,2012-03-12,661208196,81,46,0,15,2,635814,0,335814,300000,661208196,0,350410988,310797208,103,99,103,100,635814,100,-1.23222748815166
وصنعت,2012-03-13,485106638,89,35,2,28,1,370321,95217,415538,50000,385413756,99692882,433060588,52046050,101,100,101,101,465538,100,0
وصنعت,2012-03-14,805763011,92,20,1,55,0,290957,456628,747585,0,312450556,493312455,805763011,0,104,101,101,104,747585,104,3.45489443378119
وصنعت,2012-03-17,2951579349,217,31,2,104,3,594199,2050000,1834199,810000,661526611,2290052738,2045399349,906180000,108,104,105,107,2644199,107,3.52504638218924
وصنعت,2012-03-18,822450919,104,22,1,45,0,324606,412578,737184,0,362524339,459926580,822450919,0,109,107,108,107,737184,107,0
وصنعت,2012-03-24,974471781,87,18,1,44,3,806265,39603,740868,105000,929522376,44949405,853408181,121063600,112,109,109,112,845868,111,3.2258064516129
وصنعت,2012-03-25,477544601,67,19,0,28,0,416454,0,416454,0,477544601,0,477544601,0,114,108,114,109,416454,111,-0.260416666666667
وصنعت,2012-03-26,167777175,44,13,0,20,0,150345,0,150345,0,167777175,0,167777175,0,109,107,109,107,150345,110,-0.609225413402959
وصنعت,2012-03-27,548105389,62,38,0,6,0,496291,0,496291,0,548105389,0,548105389,0,109,106,108,106,496291,108,-2.18914185639229
وصنعت,2012-03-28,349721139,45,21,0,24,0,318962,0,318962,0,349721139,0,349721139,0,108,104,106,105,318962,107,-0.805729632945389
وصنعت,2012-04-02,1166468746,130,57,0,17,0,1085034,0,1085034,0,1166468746,0,1166468746,0,105,102,105,104,1085034,103,-2.97833935018051
وصنعت,2012-04-03,437607159,67,35,1,21,0,256810,150000,406810,0,276487203,161119956,437607159,0,105,102,105,102,406810,103,0
وصنعت,2012-04-04,125585434,23,8,0,13,0,116593,0,116593,0,125585434,0,125585434,0,104,103,103,104,116593,103,0
وصنعت,2012-04-07,374509870,79,34,0,20,0,352436,0,352436,0,374509870,0,374509870,0,104,101,101,102,352436,103,-0.558139534883721
وصنعت,2012-04-08,608259265,90,60,0,16,1,581677,0,431677,150000,608259265,0,451351080,156908185,103,100,103,100,581677,101,-1.68381665107577
وصنعت,2012-04-09,417194798,91,48,0,17,0,401434,0,401434,0,417194798,0,417194798,0,102,99,100,100,401434,101,-0.570884871550904
وصنعت,2012-04-10,787034968,114,50,0,25,0,757650,0,757650,0,787034968,0,787034968,0,102,99,101,101,757650,100,-0.574162679425837
وصنعت,2012-04-11,941847689,116,46,0,53,0,884253,0,884253,0,941847689,0,941847689,0,104,100,100,103,884253,103,2.50240615976901
وصنعت,2012-04-14,320128838,49,19,0,27,0,296874,0,296874,0,320128838,0,320128838,0,105,103,105,104,296874,103,0.469483568075117
وصنعت,2012-04-15,1643857152,274,63,0,85,0,1491320,0,1491320,0,1643857152,0,1643857152,0,107,105,105,107,1491320,106,2.99065420560748
وصنعت,2012-04-16,492315197,90,38,1,36,0,442324,9700,452024,0,482004097,10311100,492315197,0,109,102,109,103,452024,105,-0.725952813067151
وصنعت,2012-04-17,741355408,109,52,0,23,0,699683,0,699683,0,741355408,0,741355408,0,103,101,103,102,699683,102,-2.92504570383912
وصنعت,2012-04-18,320393017,53,26,1,20,0,252094,50000,302094,0,267293017,53100000,320393017,0,103,101,101,102,302094,102,-0.094161958568738
وصنعت,2012-04-21,259243401,71,21,0,33,0,244346,0,244346,0,259243401,0,259243401,0,103,101,101,102,244346,102,0
وصنعت,2012-04-22,384671323,65,28,1,20,0,357957,10000,367957,0,374221323,10450000,384671323,0,101,100,101,101,367957,101,-0.754005655042413
وصنعت,2012-04-23,273316607,76,34,0,22,0,258223,0,258223,0,273316607,0,273316607,0,103,100,101,102,258223,102,0.189933523266857
وصنعت,2012-04-24,202150345,59,22,0,25,0,192170,0,192170,0,202150345,0,202150345,0,102,101,101,102,192170,101,-0.09478672985782
وصنعت,2012-04-28,372122702,55,10,0,27,0,350810,0,350810,0,372122702,0,372122702,0,103,102,102,102,350810,102,0.284629981024668
وصنعت,2012-04-29,274938157,69,30,1,20,0,262638,1,262639,0,274937107,1050,274938157,0,102,100,102,100,262639,101,-0.378429517502365
وصنعت,2012-04-30,254183425,51,26,1,16,0,174239,70000,244239,0,181453425,72730000,254183425,0,101,99,101,99,244239,101,-0.379867046533713
وصنعت,2012-05-01,528835103,103,39,0,19,0,512142,0,512142,0,528835103,0,528835103,0,100,99,100,99,512142,100,-1.04861773117255
وصنعت,2012-05-02,402099807,69,39,0,20,0,391186,0,391186,0,402099807,0,402099807,0,100,98,99,99,391186,99,-0.481695568400771
وصنعت,2012-05-05,414454789,68,35,0,23,0,400646,0,400646,0,414454789,0,414454789,0,101,98,99,99,400646,100,0.096805421103582
وصنعت,2012-05-06,397393938,57,32,1,13,0,376330,10000,386330,0,387033938,10360000,397393938,0,101,98,101,99,386330,99,-0.290135396518375
وصنعت,2012-05-07,938053441,101,18,1,55,1,189251,696234,875785,9700,197517837,740535604,927713241,10340200,103,99,99,102,885485,102,2.71580989330747
وصنعت,2012-05-08,1135474640,225,39,1,76,2,571893,476736,958629,90000,620599760,514874880,1038074640,97400000,105,104,104,104,1048629,104,2.26628895184136
وصنعت,2012-05-09,465970740,72,40,3,21,0,365247,78489,443736,0,383843467,82127273,465970740,0,105,100,105,100,443736,102,-1.75438596491228
وصنعت,2012-05-12,1076369482,245,6,2,41,0,21882,1003500,1025382,0,22753982,1053615500,1076369482,0,101,99,99,101,1025382,101,-1.31578947368421
وصنعت,2012-05-13,547366829,63,35,0,20,0,535036,0,535036,0,547366829,0,547366829,0,101,98,99,99,535036,99,-1.80952380952381
وصنعت,2012-05-14,247942562,36,16,1,15,0,184214,55000,239214,0,191017562,56925000,247942562,0,101,99,101,100,239214,99,0.193986420950533
وصنعت,2012-05-15,109979944,22,10,0,13,0,105926,0,105926,0,109979944,0,109979944,0,101,99,99,100,105926,100,0.096805421103582
وصنعت,2012-05-16,271450535,54,27,1,21,0,195224,68581,263805,0,201012895,70437640,271450535,0,100,98,99,99,263805,99,-0.193423597678917
وصنعت,2012-05-19,486778823,66,38,0,17,0,474247,0,474247,0,486778823,0,486778823,0,100,98,100,98,474247,99,-0.387596899224806
وصنعت,2012-05-20,365839501,50,14,0,27,1,350575,0,320575,30000,365839501,0,334706131,31133370,101,99,100,99,350575,100,0.680933852140078
وصنعت,2012-05-21,495680755,79,35,0,34,0,472404,0,472404,0,495680755,0,495680755,0,103,99,100,99,472404,100,0.869565217391304
وصنعت,2012-05-22,427435169,64,31,0,16,0,409498,0,409498,0,427435169,0,427435169,0,102,100,100,101,409498,100,0
وصنعت,2012-05-23,1694647365,179,30,1,95,4,1323221,250000,1342434,230787,1426182927,268464438,1445151750,249495615,104,101,101,104,1573221,104,3.16091954022988
وصنعت,2012-05-26,750995036,115,39,1,26,0,712530,10000,722530,0,740635036,10360000,750995036,0,103,100,101,100,722530,100,-3.34261838440111
وصنعت,2012-05-27,529210174,66,20,1,30,0,451705,50000,501705,0,476660174,52550000,529210174,0,103,100,100,100,501705,101,0.864553314121037
وصنعت,2012-05-28,296481833,35,10,0,26,0,278634,0,278634,0,296481833,0,296481833,0,103,101,103,103,278634,102,0.476190476190476
وصنعت,2012-05-29,527411738,105,20,0,20,1,501376,0,401376,100000,527411738,0,423371786,104039952,103,100,103,101,501376,101,-0.18957345971564
وصنعت,2012-05-30,409268762,79,24,0,16,0,389861,0,389861,0,409268762,0,409268762,0,101,100,100,101,389861,101,-0.189933523266857
وصنعت,2012-06-02,339588150,33,10,0,14,0,325907,0,325907,0,339588150,0,339588150,0,101,100,101,100,325907,101,-0.380589914367269
وصنعت,2012-06-05,74019652,24,7,0,9,0,71582,0,71582,0,74019652,0,74019652,0,100,99,100,99,71582,101,-0.095510983763133
وصنعت,2012-06-06,376436167,74,30,1,19,0,346855,20000,366855,0,356016167,20420000,376436167,0,100,98,99,99,366855,100,-0.956022944550669
وصنعت,2012-06-09,440948493,76,40,2,23,0,419886,21000,440886,0,420033493,20915000,440948493,0,99,96,99,96,440886,98,-2.02702702702703
وصنعت,2012-06-10,267376573,42,8,3,26,0,113491,151000,264491,0,114556195,152820378,267376573,0,98,96,96,97,264491,98,-0.098522167487685
وصنعت,2012-06-11,227490876,42,17,1,21,2,122740,100000,121909,100831,124879318,102611558,124375188,103115688,101,97,98,98,222740,98,0.19723865877712
وصنعت,2012-06-12,323768712,53,22,1,18,1,219491,100000,264442,55049,221990692,101778020,267618732,56149980,98,97,98,97,319491,98,-0.098425196850394
وصنعت,2012-06-13,622461153,61,14,1,14,2,145319,469596,500296,114619,146169193,476291960,506491673,115969480,98,96,97,97,614915,98,-0.197044334975369
وصنعت,2012-06-16,970776176,95,45,1,11,1,959884,14560,894873,79571,956420016,14356160,891712886,79063290,98,95,97,95,974444,96,-1.6781836130306
وصنعت,2012-06-17,1409447429,134,28,1,41,0,599704,799573,1399277,0,598473559,810973870,1409447429,0,99,95,95,98,1399277,97,1.10441767068273
وصنعت,2012-06-19,62662750,13,7,0,9,0,63163,0,63163,0,62662750,0,62662750,0,96,95,96,95,63163,97,-0.099304865938431
وصنعت,2012-06-20,984081977,91,29,1,37,1,370424,611665,982067,22,361792571,622289406,984059603,22374,100,93,95,97,982089,96,-0.397614314115308
وصنعت,2012-06-23,2068836954,105,30,1,33,1,470734,1645059,2065793,50000,453580386,1615256568,2018736954,50100000,97,93,95,95,2115793,94,-2.39520958083832
وصنعت,2012-06-24,259378494,53,24,1,20,0,237746,35000,272746,0,226075494,33303000,259378494,0,94,91,94,92,272746,93,-1.02249488752556
وصنعت,2012-06-25,36243337,12,8,1,7,0,28442,10000,38442,0,26818337,9425000,36243337,0,93,91,93,91,38442,93,-0.103305785123967
وصنعت,2012-06-26,116314450,10,9,1,2,0,115150,10000,125150,0,107024450,9290000,116314450,0,90,89,90,89,125150,92,-0.62047569803516
وصنعت,2012-06-27,351000286,72,20,1,23,0,340282,40000,380282,0,314080286,36920000,351000286,0,89,89,89,89,380282,91,-1.97710718002081
وصنعت,2012-06-30,631580769,77,21,0,38,0,655299,0,655299,0,631580769,0,631580769,0,94,89,89,94,655299,92,2.01698513800425
وصنعت,2012-07-01,38587951,18,11,0,9,0,40826,0,40826,0,38587951,0,38587951,0,93,91,91,91,40826,92,-0.104058272632674
وصنعت,2012-07-02,220609619,57,19,1,22,0,205866,20000,225866,0,200855184,19754435,220609619,0,95,92,95,93,225866,93,0.520833333333333
وصنعت,2012-07-03,166894757,22,6,1,17,0,132274,37902,170176,0,129637091,37257666,166894757,0,95,92,95,93,170176,93,0.414507772020725
وصنعت,2012-07-04,277780730,43,19,1,15,1,289400,2000,288400,3000,275880730,1900000,274966730,2814000,94,90,92,94,291400,93,-0.619195046439629
وصنعت,2012-07-07,279667190,33,13,0,5,0,293400,0,293400,0,279667190,0,279667190,0,94,91,94,91,293400,92,-0.415368639667705
وصنعت,2012-07-08,1580018414,166,46,1,73,0,950779,648033,1598812,0,938418753,641599661,1580018414,0,96,90,91,96,1598812,95,3.02398331595412
وصنعت,2012-07-09,203953496,37,16,2,18,0,171662,35670,207332,0,169140515,34812981,203953496,0,96,92,96,93,207332,95,-0.101214574898785
وصنعت,2012-07-10,539993194,96,19,3,36,0,238830,305233,544063,0,235464160,304529034,539993194,0,96,94,94,96,544063,95,0.405268490374873
وصنعت,2012-07-11,280474563,50,16,1,22,0,250956,30000,280956,0,250505986,29968577,280474563,0,98,95,95,95,280956,96,0.302724520686176
وصنعت,2012-07-14,101453900,12,8,1,6,0,83500,20000,103500,0,81493900,19960000,101453900,0,96,93,93,94,103500,95,-0.201207243460765
وصنعت,2012-07-15,565571620,62,13,1,28,0,308913,268930,577843,0,299621164,265950456,565571620,0,96,93,94,93,577843,95,-1.00806451612903
وصنعت,2012-07-16,334197760,51,3,2,31,0,10000,325000,335000,0,9825000,324372760,334197760,0,98,93,93,95,335000,95,0.712830957230143
وصنعت,2012-07-17,394703728,50,13,1,28,0,127200,276778,403978,0,123048700,271655028,394703728,0,96,93,94,93,403978,95,-0.606673407482305
وصنعت,2012-07-18,111401997,35,8,1,22,0,37030,75300,112330,0,36325300,75076697,111401997,0,96,92,92,94,112330,95,0.101729399796541
وصنعت,2012-07-21,218031890,33,6,1,21,0,72200,148292,220492,0,70743050,147288840,218031890,0,96,94,94,94,220492,95,0.101626016260163
وصنعت,2012-07-22,107001287,21,5,1,12,0,37896,70854,108750,0,37119539,69881748,107001287,0,96,94,96,95,108750,95,0
وصنعت,2012-07-23,257067779,42,16,2,13,0,203738,60000,263738,0,197516797,59550982,257067779,0,96,93,96,93,263738,94,-0.406091370558376
وصنعت,2012-07-24,243102950,31,10,1,21,0,144980,100000,244980,0,143497450,99605500,243102950,0,96,94,96,95,244980,95,0.407747196738022
وصنعت,2012-07-25,229100432,22,9,1,6,0,184598,50000,234598,0,179900432,49200000,229100432,0,95,94,94,94,234598,95,-0.304568527918782
وصنعت,2012-07-28,145992994,23,16,1,8,0,146569,5685,152254,0,140580874,5412120,145992994,0,94,91,94,92,152254,94,-0.509164969450102
وصنعت,2012-07-29,75655500,18,8,1,12,0,74550,5600,80150,0,70369100,5286400,75655500,0,93,90,93,90,80150,94,-0.409416581371546
وصنعت,2012-07-30,116346450,23,11,1,14,0,94210,30000,124210,0,88266450,28080000,116346450,0,90,90,90,90,124210,93,-0.616649537512847
وصنعت,2012-07-31,139935940,30,10,0,16,0,146865,0,146865,0,139935940,0,139935940,0,92,90,90,91,146865,93,-0.31023784901758
وصنعت,2012-08-01,214733536,25,17,3,6,0,116080,114300,230380,0,107743036,106990500,214733536,0,91,89,91,89,230380,92,-1.03734439834025
وصنعت,2012-08-04,225367032,36,13,1,17,0,245154,873,246027,0,224567364,799668,225367032,0,88,88,88,88,246027,91,-1.25786163522013
وصنعت,2012-08-05,247749418,37,8,2,16,0,57720,210000,267720,0,52236600,195512818,247749418,0,90,87,87,87,267720,90,-0.636942675159236
وصنعت,2012-08-06,930265410,86,25,2,30,0,517898,508500,1026398,0,466695009,463570401,930265410,0,90,87,87,87,1026398,87,-3.20512820512821
وصنعت,2012-08-07,231907120,35,12,1,14,0,236100,30000,266100,0,205807120,26100000,231907120,0,87,84,87,84,266100,86,-1.32450331125828
وصنعت,2012-08-08,230027534,66,21,1,21,0,213174,50000,263174,0,187077534,42950000,230027534,0,86,83,84,85,263174,85,-0.782997762863535
وصنعت,2012-08-11,79888565,37,12,0,7,0,88624,0,88624,0,79888565,0,79888565,0,88,86,86,87,88624,86,0.225479143179256
وصنعت,2012-08-12,28186180,11,6,0,6,0,31280,0,31280,0,28186180,0,28186180,0,87,87,87,87,31280,86,0.112485939257593
وصنعت,2012-08-13,110418975,36,20,1,7,0,121585,6100,127685,0,105179075,5239900,110418975,0,86,82,86,83,127685,85,-0.449438202247191
وصنعت,2012-08-14,13982470,3,1,0,3,0,16078,0,16078,0,13982470,0,13982470,0,85,83,85,83,16078,85,0
وصنعت,2012-08-15,42741477,15,6,0,10,0,48279,0,48279,0,42741477,0,42741477,0,85,83,83,85,48279,85,0
وصنعت,2012-08-18,212163555,47,19,1,8,1,216485,30000,134624,111861,186213555,25950000,115482655,96680900,86,82,86,83,246485,85,-0.90293453724605
وصنعت,2012-08-21,120091500,26,9,0,4,2,137462,0,45962,91500,120091500,0,39959000,80132500,84,82,82,84,137462,84,-0.113895216400911
وصنعت,2012-08-22,72789700,20,7,0,10,0,83248,0,83248,0,72789700,0,72789700,0,85,83,85,83,83248,84,0
وصنعت,2012-08-25,23903030,10,7,0,5,0,27356,0,27356,0,23903030,0,23903030,0,86,84,86,84,27356,84,0
وصنعت,2012-08-26,124726338,34,17,1,15,0,142976,1250,144226,0,123660088,1066250,124726338,0,86,81,83,85,144226,84,-0.228050171037628
وصنعت,2012-08-27,170337613,39,20,1,9,2,179532,20000,117660,81872,153149923,17187690,100638730,69698883,85,81,83,83,199532,84,-0.685714285714286
وصنعت,2012-09-02,67143500,24,11,1,6,0,58700,20000,78700,0,50063500,17080000,67143500,0,83,81,81,83,78700,83,-0.230149597238205
وصنعت,2012-09-03,373109579,66,34,0,21,0,429944,0,429944,0,373109579,0,373109579,0,85,83,83,85,429944,83,0
وصنعت,2012-09-04,458620205,69,25,1,33,2,256776,253135,494911,15000,231143429,227476776,445105205,13515000,87,85,85,87,509911,86,2.53748558246828
وصنعت,2012-09-05,397722768,77,12,1,38,0,147523,286814,434337,0,133752220,263970548,397722768,0,89,87,87,88,434337,87,1.68728908886389
وصنعت,2012-09-08,1327987913,105,18,0,50,2,1420977,0,1164408,256569,1327987913,0,1092102467,235885446,90,87,87,90,1420977,90,3.42920353982301
وصنعت,2012-09-09,911064297,136,17,1,56,0,691809,275618,967427,0,651101381,259962916,911064297,0,92,87,92,90,967427,91,0.748663101604278
وصنعت,2012-09-10,179065476,48,11,0,19,0,193158,0,193158,0,179065476,0,179065476,0,92,88,91,89,193158,90,-0.424628450106157
وصنعت,2012-09-11,755526948,78,7,1,51,0,52716,732186,784902,0,50385335,705141613,755526948,0,94,91,91,92,784902,93,2.66524520255864
وصنعت,2012-09-15,727055604,73,15,2,38,1,328557,400000,727684,873,328203130,398852474,726183477,872127,96,93,93,96,728557,96,3.53063343717549
وصنعت,2012-09-16,2251938108,117,25,1,53,2,1675631,500000,1665631,510000,1733938108,518000000,1723578108,528360000,100,97,98,100,2175631,100,3.81143430290873
وصنعت,2012-09-17,2105856865,172,40,2,70,5,1935350,27849,1511199,452000,2076785905,29070960,1619984865,485872000,104,100,101,104,1963199,103,3.67149758454106
وصنعت,2012-09-18,2583166223,177,47,2,59,4,1152290,1205000,1739290,618000,1257746017,1325420206,1911508912,671657311,107,104,105,105,2357290,105,2.14352283317801
وصنعت,2012-09-19,1128514816,90,20,1,44,0,413109,600000,1013109,0,457155589,671359227,1128514816,0,109,105,105,105,1013109,107,1.64233576642336
وصنعت,2012-09-22,2152380518,177,73,1,41,1,1864957,80000,1790957,154000,2063690518,88690000,1984074503,168306015,110,103,107,107,1944957,107,-0.628366247755835
وصنعت,2012-09-23,34853822890,142,50,4,60,2,823443,30327700,1228614,29922529,895000011,33958822879,1351781160,33502041730,108,102,108,108,31151143,108,1.0840108401084
وصنعت,2012-09-24,480143316,61,24,0,26,1,438207,0,306696,131511,480143316,0,336100771,144042545,106,104,105,105,438207,106,-1.25111706881144
وصنعت,2012-09-25,939070782,112,26,1,51,2,537470,300000,817981,19489,602222174,336848608,917437992,21632790,109,106,107,107,837470,108,1.44796380090498
وصنعت,2012-09-26,1921116481,106,4,0,63,3,1656037,0,1449686,206351,1921116481,0,1680803306,240313175,112,108,108,112,1656037,112,3.47903657448707
وصنعت,2012-09-29,1539818388,68,24,0,37,1,1276798,0,976798,300000,1539818388,0,1178018388,361800000,116,116,116,116,1276798,116,3.96551724137931
وصنعت,2012-09-30,3090171122,199,49,1,105,2,1967168,539092,2407057,99203,2433434149,656736973,2965770560,124400562,121,114,121,117,2506260,119,2.23880597014925
وصنعت,2012-10-01,4056727516,134,7,2,58,0,122307,3300000,3422307,0,144827488,3911900028,4056727516,0,117,114,114,114,3422307,114,-3.89294403892944
وصنعت,2012-10-02,103461270,16,11,0,1,0,90915,0,90915,0,103461270,0,103461270,0,110,110,110,110,90915,113,-0.506329113924051
وصنعت,2012-10-03,4576770585,320,145,1,73,1,4001459,10000,3953205,58254,4565450585,11320000,4509487215,67283370,113,109,109,109,4011459,110,-3.22307039864292
وصنعت,2012-10-06,157552515,25,13,0,13,0,143691,0,143691,0,157552515,0,157552515,0,106,105,106,105,143691,109,-0.788781770376862
وصنعت,2012-10-07,575242131,51,26,1,20,1,482404,46609,429013,100000,524578148,50663983,466497231,108744900,105,105,105,105,529013,106,-2.73851590106007
وصنعت,2012-10-08,265571980,56,14,0,22,1,243080,0,243070,10,265571980,0,265560690,11290,109,104,104,107,243080,106,-0.272479564032698
وصنعت,2012-10-09,716490800,71,34,2,17,1,622037,45100,270848,396289,668484800,48006000,294054568,422436232,107,102,107,102,667137,104,-1.91256830601093
وصنعت,2012-10-10,78998930,31,14,0,13,0,75395,0,75395,0,78998930,0,78998930,0,103,100,103,100,75395,103,-0.278551532033426
وصنعت,2012-10-13,398551232,64,32,1,14,0,374614,10000,384614,0,388081232,10470000,398551232,0,103,99,101,99,384614,102,-1.76908752327747
وصنعت,2012-10-14,400661659,68,35,2,23,0,338611,43750,382361,0,354610409,46051250,400661659,0,102,99,100,102,382361,101,-0.37914691943128
وصنعت,2012-10-15,931754929,137,37,1,41,2,565344,290000,733645,121699,614784929,316970000,798773622,132981307,105,103,103,103,855344,105,3.61560418648906
وصنعت,2012-10-16,569547966,87,28,0,28,0,517654,0,517654,0,569547966,0,569547966,0,108,103,104,103,517654,106,0.734618916437098
وصنعت,2012-10-17,572610229,91,42,0,24,0,529089,0,529089,0,572610229,0,572610229,0,105,103,105,105,529089,105,-0.911577028258888
وصنعت,2012-10-20,1133972603,153,46,0,56,2,1015883,0,772438,243445,1133972603,0,860926748,273045855,109,105,105,108,1015883,107,2.66789328426863
وصنعت,2012-10-21,976315566,125,34,0,45,0,870524,0,870524,0,976315566,0,976315566,0,110,106,110,108,870524,108,0.537634408602151
وصنعت,2012-10-22,777817557,86,43,1,21,0,640053,75000,715053,0,696617557,81200000,777817557,0,106,104,105,104,715053,105,-2.94117647058824
وصنعت,2012-10-23,1700168893,132,67,2,16,1,1401985,220000,245179,1376806,1470048893,230120000,257213573,1442955320,104,101,104,103,1621985,101,-3.76492194674013
وصنعت,2012-10-24,772699987,106,41,0,26,0,725071,0,725071,0,772699987,0,772699987,0,104,101,102,103,725071,103,1.62213740458015
وصنعت,2012-10-27,1135923208,125,45,1,44,1,1030112,10000,940112,100000,1125153208,10770000,1025923208,110000000,106,103,104,104,1040112,105,2.53521126760563
وصنعت,2012-10-28,730309198,114,35,0,31,0,671737,0,671737,0,730309198,0,730309198,0,108,104,107,104,671737,105,-0.366300366300366
وصنعت,2012-10-29,781566334,145,62,0,35,1,738218,0,718218,20000,781566334,0,760223218,21343116,105,101,105,102,738218,102,-2.66544117647059
وصنعت,2012-11-04,148155656,31,19,0,12,0,141013,0,141013,0,148155656,0,148155656,0,104,100,104,100,141013,102,-0.188857412653447
وصنعت,2012-11-05,441667028,73,35,1,20,0,359613,70000,429613,0,369467028,72200000,441667028,0,101,98,100,98,429613,100,-1.60832544938505
وصنعت,2012-11-06,440657735,62,24,1,29,0,415702,15000,430702,0,425365307,15292428,440657735,0,99,98,99,99,430702,99,-0.961538461538462
وصنعت,2012-11-07,386622683,67,20,0,24,0,372880,0,372880,0,386622683,0,386622683,0,101,99,99,100,372880,99,0.29126213592233
وصنعت,2012-11-10,296588626,48,20,0,15,0,285993,0,285993,0,296588626,0,296588626,0,102,99,102,100,285993,100,0.193610842207164
وصنعت,2012-11-11,344122425,68,28,1,17,0,331874,6000,337874,0,338042425,6080000,344122425,0,100,97,99,97,337874,99,-0.676328502415459
وصنعت,2012-11-12,405600870,65,34,1,22,0,400218,1891,402109,0,403702306,1898564,405600870,0,98,97,97,97,402109,98,-0.972762645914397
وصنعت,2012-11-13,565854648,60,26,1,19,0,551814,6000,557814,0,559818648,6036000,565854648,0,99,97,97,99,557814,98,-0.294695481335953
وصنعت,2012-11-14,175568389,37,21,0,14,0,171699,0,171699,0,175568389,0,175568389,0,100,98,100,99,171699,98,0.197044334975369
وصنعت,2012-11-17,260463468,46,19,0,21,0,255405,0,255405,0,260463468,0,260463468,0,100,97,98,98,255405,98,0.098328416912488
وصنعت,2012-11-18,836001544,76,25,0,40,0,790768,0,790768,0,836001544,0,836001544,0,102,99,102,102,790768,102,3.83104125736739
وصنعت,2012-11-19,1069352386,145,58,0,45,1,985714,0,901823,83891,1069352386,0,978650106,90702280,105,103,105,104,985714,104,2.64900662251656
وصنعت,2012-11-20,500149207,57,21,0,21,0,467229,0,467229,0,500149207,0,500149207,0,104,102,103,104,467229,104,-0.829493087557604
وصنعت,2012-11-21,390459981,82,29,0,37,0,358838,0,358838,0,390459981,0,390459981,0,106,102,102,105,358838,104,0.557620817843866
وصنعت,2012-11-26,602243184,71,29,0,19,1,555590,0,285130,270460,602243184,0,308955540,293287644,106,104,104,105,555590,104,0.092421441774492
وصنعت,2012-11-27,982324639,99,30,0,32,1,909082,0,509082,400000,982324639,0,550624210,431700429,105,103,105,104,909082,104,-0.184672206832872
وصنعت,2012-11-28,1109736930,105,42,0,35,2,1026557,0,590192,436365,1109736930,0,638283515,471453415,105,103,104,104,1026557,104,0
وصنعت,2012-12-01,890467647,89,38,0,34,1,820091,0,520091,300000,890467647,0,564880201,325587446,105,103,103,105,820091,105,0.462534690101758
وصنعت,2012-12-02,1434043700,168,57,0,69,1,1275915,0,1265915,10000,1434043700,0,1422863700,11180000,109,104,105,108,1275915,108,3.49907918968692
وصنعت,2012-12-03,697807761,110,22,0,51,0,616971,0,616971,0,697807761,0,697807761,0,111,105,105,111,616971,109,0.533807829181495
وصنعت,2012-12-04,621116808,88,23,0,33,0,545020,0,545020,0,621116808,0,621116808,0,110,108,109,109,545020,109,0.619469026548672
وصنعت,2012-12-05,325962064,60,26,0,23,0,291177,0,291177,0,325962064,0,325962064,0,109,105,105,109,291177,109,-0.615655233069481
وصنعت,2012-12-08,460122950,34,9,0,24,1,391594,0,381594,10000,460122950,0,448372950,11750000,113,113,113,113,391594,111,2.0353982300885
وصنعت,2012-12-09,5392771081,443,159,4,147,5,4264660,239666,3231678,1272648,5105411547,287359534,3867466129,1525304952,115,113,115,115,4504326,115,3.81613183000867
وصنعت,2012-12-10,3509630530,376,131,1,120,2,2775933,130000,2805903,100030,3351933410,157697120,3389070606,120559924,119,112,117,115,2905933,116,0.918964076858813
وصنعت,2012-12-11,1235931460,140,70,0,40,0,1045134,0,1045134,0,1235931460,0,1235931460,0,118,112,116,112,1045134,114,-2.06953642384106
وصنعت,2012-12-12,1659211639,221,59,0,70,0,1436485,0,1436485,0,1659211639,0,1659211639,0,114,110,111,112,1436485,111,-2.36686390532544
وصنعت,2012-12-15,707204195,82,23,0,38,0,607054,0,607054,0,707204195,0,707204195,0,114,111,111,112,607054,112,0.692640692640693
وصنعت,2012-12-16,866590436,87,24,0,50,0,747855,0,747855,0,866590436,0,866590436,0,114,111,114,112,747855,112,-0.343938091143594
وصنعت,2012-12-17,739670386,82,35,0,29,1,646896,0,546896,100000,739670386,0,625570386,114100000,111,110,111,110,646896,110,-1.12165660051769
وصنعت,2012-12-18,729240144,73,24,1,33,1,235855,400000,595328,40527,269269764,459970380,682634094,46606050,112,109,111,110,635855,110,0.087260034904014
وصنعت,2012-12-19,2757520373,258,44,2,92,1,1634957,700000,2275484,59473,1923392821,834127552,2688650639,68869734,115,111,111,115,2334957,114,2.9642545771578
وصنعت,2012-12-22,3088133956,281,67,2,90,3,1737693,794523,1860016,672200,2121451366,966682590,2265006556,823127400,118,114,118,118,2532216,117,3.30228619813717
وصنعت,2012-12-23,1672415863,198,50,1,69,0,901580,455865,1357445,0,1111868162,560547701,1672415863,0,119,116,118,119,1357445,119,0.983606557377049
وصنعت,2012-12-24,4689769520,345,54,3,101,3,859260,2965050,3638595,185715,1046121620,3643647900,4460978495,228791025,121,114,118,118,3824310,118,-0.487012987012987
وصنعت,2012-12-25,1945417923,272,40,1,67,0,611159,1000000,1611159,0,725839933,1219577990,1945417923,0,118,113,117,114,1611159,116,-1.54975530179445
وصنعت,2012-12-26,1744217393,158,43,1,61,0,916207,500000,1416207,0,1129392376,614825017,1744217393,0,120,117,118,118,1416207,119,2.07125103562552
وصنعت,2012-12-29,1322338686,105,32,1,54,0,563887,500000,1063887,0,699608976,622729710,1322338686,0,121,117,117,120,1063887,120,0.892857142857143
وصنعت,2012-12-30,575211300,119,42,0,37,2,462606,0,445556,17050,575211300,0,553911095,21300205,121,119,121,119,462606,120,0
وصنعت,2012-12-31,2635337470,201,48,3,83,4,1507403,550000,1307737,749666,1926070592,709266878,1672304080,963033390,124,119,121,124,2057403,123,3.05711987127916
وصنعت,2013-01-01,3869116796,175,88,2,63,7,2802816,115000,1724463,1193353,3715936796,153180000,2290380516,1578736280,128,124,128,124,2917816,128,3.51288056206089
وصنعت,2013-01-02,2319670078,224,69,2,85,2,1148466,650000,1533466,265000,1472477192,847192886,1979567178,340102900,127,123,125,123,1798466,124,-2.71493212669683
وصنعت,2013-01-06,5982351440,418,57,2,108,3,747670,3975255,2992947,1729978,929173061,5053178379,3795356080,2186995360,125,119,121,124,4722925,122,-1.78294573643411
وصنعت,2013-01-07,4357593916,345,45,3,123,2,391828,3000100,2957331,434597,498729634,3858864282,3801459069,556134847,126,120,125,122,3391928,124,1.42067876874507
وصنعت,2013-01-14,579650956,107,41,1,29,0,367703,167430,535133,0,398548556,181102400,579650956,0,123,119,123,122,535133,120,-2.86995515695067
وصنعت,2013-01-15,1330574662,170,47,2,45,0,543300,718200,1261500,0,574323192,756251470,1330574662,0,121,115,121,118,1261500,117,-2.5854108956602
وصنعت,2013-01-16,295338207,56,28,1,19,0,202926,79651,282577,0,212374792,82963415,295338207,0,118,115,115,116,282577,117,-0.37914691943128
وصنعت,2013-01-19,444800573,87,41,1,26,1,397394,35973,391282,42085,408108113,36692460,401675393,43125180,116,112,114,113,433367,115,-1.33206470028544
وصنعت,2013-01-20,529338917,66,21,1,28,0,413265,100000,513265,0,425761661,103577256,529338917,0,117,113,117,114,513265,115,-0.38572806171649
وصنعت,2013-01-21,2287943248,136,45,3,42,0,604618,1611009,2215627,0,616922648,1671020600,2287943248,0,116,111,116,112,2215627,115,0
وصنعت,2013-01-22,1796996077,129,32,3,50,1,399824,1372456,1722280,50000,402666983,1394329094,1745656077,51340000,115,110,113,114,1772280,112,-1.83930300096805
وصنعت,2013-01-23,388873333,63,17,1,30,1,274463,100000,354463,20000,285244971,103628362,368233333,20640000,117,113,113,115,374463,114,1.18343195266272
وصنعت,2013-01-26,73524394,35,8,1,15,0,66732,5000,71732,0,68413530,5110864,73524394,0,116,113,116,114,71732,114,0
وصنعت,2013-01-27,192167152,39,8,1,15,0,140100,50000,190100,0,141609652,50557500,192167152,0,114,111,114,111,190100,113,-0.389863547758285
وصنعت,2013-01-28,205732230,42,20,1,13,1,164870,40000,154870,50000,165568230,40164000,155640308,50091922,113,111,112,111,204870,113,-0.489236790606654
وصنعت,2013-01-30,100994044,34,12,1,11,0,90830,10000,100830,0,91084044,9910000,100994044,0,112,110,111,112,100830,113,-0.196656833824975
وصنعت,2013-02-02,184001148,34,10,2,15,0,162380,20100,182480,0,163741648,20259500,184001148,0,113,111,112,112,182480,112,-0.197044334975369
وصنعت,2013-02-03,186311230,48,17,1,19,0,160819,25000,185819,0,161301251,25009979,186311230,0,112,110,111,111,185819,112,-0.296150049358342
وصنعت,2013-02-04,211809250,28,8,1,19,0,202824,10000,212824,0,201879250,9930000,211809250,0,111,110,110,111,212824,112,-0.396039603960396
وصنعت,2013-02-05,219103365,73,23,1,13,0,182231,40000,222231,0,179672701,39430664,219103365,0,111,109,109,109,222231,111,-0.596421471172962
وصنعت,2013-02-06,1052346295,111,24,2,51,0,749337,277216,1026553,0,770178276,282168019,1052346295,0,115,108,109,114,1026553,114,2.5
وصنعت,2013-02-09,138375475,40,7,0,15,0,135546,0,135546,0,138375475,0,138375475,0,115,111,114,112,135546,114,-0.097560975609756
وصنعت,2013-02-11,183192935,57,23,1,18,0,161232,21000,182232,0,162138915,21054020,183192935,0,114,111,114,113,182232,113,-0.48828125
وصنعت,2013-02-12,112967814,29,11,1,9,0,110701,2500,113201,0,110490314,2477500,112967814,0,111,110,111,110,113201,113,-0.294406280667321
وصنعت,2013-02-13,194254230,33,18,1,14,0,174601,21000,195601,0,173448230,20806000,194254230,0,111,109,110,110,195601,112,-0.590551181102362
وصنعت,2013-02-16,331228483,39,18,1,19,0,321144,10000,331144,0,321269183,9959300,331228483,0,112,109,111,112,331144,112,-0.396039603960396
وصنعت,2013-02-17,215201171,48,19,1,17,0,185629,30000,215629,0,185501171,29700000,215201171,0,113,109,111,109,215629,111,-0.198807157057654
وصنعت,2013-02-18,235960161,44,25,1,15,1,199091,40000,189091,50000,196437661,39522500,186662196,49297965,111,109,111,109,239091,111,-0.49800796812749
وصنعت,2013-02-19,208169630,31,11,0,15,0,206293,0,206293,0,208169630,0,208169630,0,113,109,109,111,206293,111,0.3003003003003
وصنعت,2013-02-20,709310913,73,11,2,27,0,194670,507298,701968,0,195058810,514252103,709310913,0,114,109,110,111,701968,112,0.798403193612774
وصنعت,2013-02-23,399356846,52,16,2,29,0,91614,300000,391614,0,93230254,306126592,399356846,0,114,112,112,113,391614,113,0.495049504950495
وصنعت,2013-02-24,452840550,73,8,2,44,0,139417,300000,439417,0,143390337,309450213,452840550,0,116,111,113,111,439417,114,0.886699507389162
وصنعت,2013-02-25,144747616,44,26,0,15,0,145683,0,145683,0,144747616,0,144747616,0,111,109,111,109,145683,113,-0.5859375
وصنعت,2013-02-26,352551433,42,13,1,22,0,42847,300469,343316,0,42803894,309747539,352551433,0,115,109,109,111,343316,113,0.392927308447937
وصنعت,2013-02-27,310341103,53,14,1,35,0,102677,200000,302677,0,103647305,206693798,310341103,0,115,111,111,112,302677,113,0.097847358121331
وصنعت,2013-03-02,615323690,73,33,2,15,0,363890,245000,608890,0,362533690,252790000,615323690,0,115,109,112,111,608890,112,-0.977517106549365
وصنعت,2013-03-03,269744181,44,10,2,26,0,54560,210000,264560,0,54342060,215402121,269744181,0,115,110,113,111,264560,113,0.197433366238894
وصنعت,2013-03-04,564524256,67,18,2,28,0,200740,350000,550740,0,203182794,361341462,564524256,0,115,110,111,112,550740,113,0.689655172413793
وصنعت,2013-03-05,363792582,40,5,1,25,0,152023,200000,352023,0,156128082,207664500,363792582,0,115,112,115,114,352023,114,0.489236790606654
وصنعت,2013-03-06,322176118,28,11,1,15,0,111890,200000,311890,0,115044020,207132098,322176118,0,115,112,112,114,311890,114,0.194741966893866
وصنعت,2013-03-09,429461011,52,19,1,29,0,215176,200000,415176,0,221718378,207742633,429461011,0,115,112,115,113,415176,114,0.291545189504373
وصنعت,2013-03-10,1000378045,82,7,2,42,0,58990,900000,958990,0,60893410,939484635,1000378045,0,118,112,113,116,958990,116,1.06589147286822
وصنعت,2013-03-11,489435000,66,9,1,40,1,57253,400000,402253,55000,60794420,428640580,430585000,58850000,120,115,116,115,457253,118,1.62991371045062
وصنعت,2013-03-12,504261603,54,10,2,31,0,170858,300000,470858,0,181917533,322344070,504261603,0,120,113,114,116,470858,118,0.660377358490566
وصنعت,2013-03-13,959466486,96,29,2,37,0,308878,600000,908878,0,318157392,641309094,959466486,0,121,114,115,120,908878,117,-1.03092783505155
وصنعت,2013-03-16,3616976196,325,16,2,93,0,638974,2685758,3324732,0,694760764,2922215432,3616976196,0,122,116,116,122,3324732,121,3.03030303030303
وصنعت,2013-03-27,419101523,94,30,0,34,1,373445,0,353445,20000,419101523,0,397101523,22000000,127,121,122,127,373445,125,3.31491712707182
وصنعت,2013-03-30,136875750,28,12,0,15,0,119326,0,119326,0,136875750,0,136875750,0,130,125,128,125,119326,125,0.35650623885918
وصنعت,2013-03-31,103173152,39,21,0,18,0,93138,0,93138,0,103173152,0,103173152,0,125,121,125,122,93138,125,-0.177619893428064
وصنعت,2013-04-03,18958950,6,6,0,4,0,17435,0,17435,0,18958950,0,18958950,0,126,120,126,121,17435,125,-0.088967971530249
وصنعت,2013-04-06,252969776,41,18,0,12,0,233767,0,233767,0,252969776,0,252969776,0,122,120,121,122,233767,123,-1.15761353517364
وصنعت,2013-04-07,113092853,25,9,0,13,0,104725,0,104725,0,113092853,0,113092853,0,121,119,120,119,104725,123,-0.36036036036036
وصنعت,2013-04-08,155164677,30,6,0,10,0,144335,0,144335,0,155164677,0,155164677,0,120,119,120,119,144335,122,-0.54249547920434
وصنعت,2013-04-09,83254181,28,14,0,18,0,76781,0,76781,0,83254181,0,83254181,0,121,119,119,120,76781,122,-0.181818181818182
وصنعت,2013-04-10,191412710,40,17,0,20,0,176399,0,176399,0,191412710,0,191412710,0,122,119,121,119,176399,122,-0.273224043715847
وصنعت,2013-04-13,91595315,18,6,0,14,0,84823,0,84823,0,91595315,0,91595315,0,122,119,119,120,84823,121,-0.182648401826484
وصنعت,2013-04-15,195104418,113,11,0,13,0,182792,0,182792,0,195104418,0,195104418,0,120,118,118,118,182792,121,-0.548947849954254
وصنعت,2013-04-16,199407760,51,11,0,17,0,187214,0,187214,0,199407760,0,199407760,0,120,118,118,119,187214,120,-0.459981600735971
وصنعت,2013-04-17,151188592,32,13,0,9,0,141705,0,141705,0,151188592,0,151188592,0,120,118,119,118,141705,120,-0.277264325323475
وصنعت,2013-04-20,553113910,46,12,0,29,0,494774,0,494774,0,553113910,0,553113910,0,125,120,120,125,494774,123,2.40963855421687
وصنعت,2013-04-21,553234912,93,39,0,22,0,500403,0,500403,0,553234912,0,553234912,0,127,121,124,122,500403,123,0
وصنعت,2013-04-22,261572770,44,15,0,24,0,233679,0,233679,0,261572770,0,261572770,0,126,122,122,124,233679,123,0.361990950226244
وصنعت,2013-04-23,555976147,53,12,1,37,0,260941,224482,485423,0,297441792,258534355,555976147,0,128,123,123,128,485423,126,2.16411181244364
وصنعت,2013-04-24,142410961,40,21,0,17,0,123538,0,123538,0,142410961,0,142410961,0,131,126,131,129,123538,126,0.264783759929391
وصنعت,2013-04-27,301779507,47,20,0,24,0,260896,0,260896,0,301779507,0,301779507,0,130,128,128,128,260896,127,0.616197183098592
وصنعت,2013-04-28,471245724,61,20,0,29,0,412924,0,412924,0,471245724,0,471245724,0,130,125,127,125,412924,127,-0.087489063867017
وصنعت,2013-04-29,562042437,83,30,0,26,1,493714,0,468401,25313,562042437,0,532687479,29354958,130,125,126,126,493714,127,-0.175131348511384
وصنعت,2013-04-30,805081901,51,24,0,11,1,712781,0,513612,199169,805081901,0,579888563,225193338,129,125,129,125,712781,126,-0.87719298245614
وصنعت,2013-05-01,337366608,45,32,0,18,0,300443,0,300443,0,337366608,0,337366608,0,126,125,126,125,300443,125,-0.265486725663717
وصنعت,2013-05-04,519233759,70,24,0,22,1,458571,0,428571,30000,519233759,0,485324176,33909583,128,125,128,125,458571,126,0.266193433895297
وصنعت,2013-05-05,165098999,26,11,0,11,0,146293,0,146293,0,165098999,0,165098999,0,127,125,127,125,146293,126,0
وصنعت,2013-05-06,512329737,63,32,0,11,0,464523,0,464523,0,512329737,0,512329737,0,125,121,125,121,464523,124,-1.50442477876106
وصنعت,2013-05-07,130258885,23,11,0,12,0,119370,0,119370,0,130258885,0,130258885,0,123,121,121,122,119370,123,-0.269541778975741
وصنعت,2013-05-08,207274155,39,12,0,22,0,187130,0,187130,0,207274155,0,207274155,0,126,121,123,121,187130,123,-0.09009009009009
وصنعت,2013-05-11,204331872,51,21,0,14,0,187744,0,187744,0,204331872,0,204331872,0,122,121,121,122,187744,123,-0.450856627592426
وصنعت,2013-05-12,516239212,65,19,0,36,0,457861,0,457861,0,516239212,0,516239212,0,127,122,125,127,457861,124,1.26811594202899
وصنعت,2013-05-13,246277216,49,9,0,20,0,219373,0,219373,0,246277216,0,246277216,0,126,123,126,125,219373,124,0.089445438282648
وصنعت,2013-05-14,128306432,36,13,0,14,0,116424,0,116424,0,128306432,0,128306432,0,123,121,123,123,116424,124,-0.268096514745308
وصنعت,2013-05-15,92960509,24,11,0,11,0,84507,0,84507,0,92960509,0,92960509,0,125,121,121,121,84507,124,-0.17921146953405
وصنعت,2013-05-18,240496966,33,12,0,13,0,222120,0,222120,0,240496966,0,240496966,0,122,119,121,119,222120,123,-0.807899461400359
وصنعت,2013-05-19,63848650,21,8,0,12,0,58983,0,58983,0,63848650,0,63848650,0,122,119,119,122,58983,123,-0.180995475113122
وصنعت,2013-05-20,71290780,8,6,0,6,0,65134,0,65134,0,71290780,0,71290780,0,123,120,123,122,65134,122,-0.090661831368994
وصنعت,2013-05-21,165535207,19,10,0,10,0,150600,0,150600,0,165535207,0,165535207,0,123,119,122,119,150600,122,-0.090744101633394
وصنعت,2013-05-22,516267650,60,19,0,11,0,486325,0,486325,0,516267650,0,516267650,0,120,117,119,118,486325,119,-2.36148955495005
وصنعت,2013-05-25,587482812,68,20,0,27,0,534524,0,534524,0,587482812,0,587482812,0,124,119,121,124,534524,121,1.58139534883721
وصنعت,2013-05-26,846781077,81,35,2,28,0,538117,210000,748117,0,608830477,237950600,846781077,0,126,123,126,126,748117,126,3.66300366300366
وصنعت,2013-05-27,1841091087,110,22,0,56,0,1571950,0,1571950,0,1841091087,0,1841091087,0,131,127,127,131,1571950,130,3.4452296819788
وصنعت,2013-05-28,4001889091,97,38,1,14,1,3188323,100000,88323,3200000,3880189091,121700000,107489091,3894400000,135,135,135,135,3288323,135,3.92826643894108
وصنعت,2013-05-29,938977875,24,18,0,9,1,742275,0,222275,520000,938977875,0,281177875,657800000,141,141,141,141,742275,141,3.94412489728841
وصنعت,2013-06-01,24640872296,518,128,4,108,3,14710840,4027972,3379216,15359596,19344381116,5296491180,4443003556,20197868740,146,144,146,146,18738812,146,3.95256916996047
وصنعت,2013-06-02,1025800901,26,13,1,11,1,650403,100000,42411,707992,889100901,136700000,57975837,967825064,152,152,152,152,750403,152,3.95437262357414
وصنعت,2013-06-03,3593709000,64,69,3,10,1,2239000,290000,629000,1900000,3181619000,412090000,893809000,2699900000,158,158,158,158,2529000,158,3.95025603511339
وصنعت,2013-06-08,20779713888,710,217,8,207,3,11987333,2210000,12835333,1362000,17546047888,3233666000,18770813090,2008900798,164,156,164,157,14197333,163,3.02603800140746
وصنعت,2013-06-09,1314852574,83,28,1,31,0,634951,300000,934951,0,893052574,421800000,1314852574,0,157,156,156,156,934951,156,-3.96174863387978
وصنعت,2013-06-10,7727977240,377,89,4,150,2,4660963,759000,5181659,238304,6628685173,1099292067,7379576792,348400448,162,150,150,162,5419963,158,1.42247510668563
وصنعت,2013-06-11,600229420,37,10,0,26,0,404740,0,404740,0,600229420,0,600229420,0,165,165,165,165,404740,162,2.17391304347826
وصنعت,2013-06-12,991864440,41,10,0,24,1,654696,0,580361,74335,991864440,0,879246915,112617525,168,168,168,168,654696,168,3.50034317089911
وصنعت,2013-06-15,3202953600,49,29,1,5,1,1967700,75000,42700,2000000,3085353600,117600000,66953600,3136000000,174,174,174,174,2042700,174,3.97877984084881
وصنعت,2013-06-16,10196440609,363,172,1,100,3,5873876,450000,5453771,870105,9462940609,733500000,8815232615,1381207994,181,170,181,179,6323876,179,2.80612244897959
وصنعت,2013-06-17,6742420098,324,88,4,86,2,3776516,560000,3511516,825000,5875033754,867386344,5451244908,1291175190,178,172,178,174,4336516,173,-3.53598014888338
وصنعت,2013-06-18,3984165550,140,41,1,43,2,2249027,225000,2215132,258895,3620770764,363394786,3567391230,416774320,180,174,176,180,2474027,179,3.53697749196141
وصنعت,2013-06-19,7790175907,321,100,3,99,6,4016774,668493,3438353,1246914,6680001518,1110174389,5715034134,2075141773,186,178,183,182,4685267,185,3.29192546583851
وصنعت,2013-06-22,6926981097,364,135,1,65,4,3590218,500000,2689194,1401024,6069465734,857515363,4548001882,2378979215,192,182,185,184,4090218,188,1.86410102224895
وصنعت,2013-06-23,3463282054,216,73,0,77,2,2094628,0,1890554,204074,3463282054,0,3125679374,337602680,189,181,189,181,2094628,184,-2.42030696576151
وصنعت,2013-06-25,1666208780,111,30,1,57,2,1014586,2000,952818,63768,1662964780,3244000,1560788102,105420678,184,179,184,184,1016586,182,-0.846944948578342
وصنعت,2013-06-26,9329779936,271,87,3,76,8,4982271,500000,1953965,3528306,8478124084,851655852,3318056100,6011723836,189,180,180,189,5482271,189,3.8438071995119
وصنعت,2013-06-29,2401212090,45,13,1,20,1,1341737,14880,356617,1000000,2374874490,26337600,631212090,1770000000,197,197,197,197,1356617,197,3.99529964747356
وصنعت,2013-06-30,8631763020,179,88,6,49,2,3971316,720000,3653390,1037926,7306963020,1324800000,6721979180,1909783840,204,202,204,204,4691316,204,3.95480225988701
وصنعت,2013-07-01,10640344505,257,116,3,50,6,4386061,1177658,2197357,3366362,8387504751,2252839754,4202366743,6437977762,213,209,213,213,5563719,212,3.91304347826087
وصنعت,2013-07-02,117075852703,1996,348,12,106,4,55260479,4985000,13325479,46920000,107381728703,9694124000,26430544690,90645308013,221,213,221,221,60245479,216,1.62133891213389
وصنعت,2013-07-03,5959606000,68,74,3,6,1,2761300,189000,7551,2942749,5577826000,381780000,15253020,5944352980,224,224,224,224,2950300,224,3.96294390118374
وصنعت,2013-07-06,1575000000,25,13,0,4,2,750000,0,22292,727708,1575000000,0,46813200,1528186800,233,233,233,233,750000,233,3.96039603960396
وصنعت,2013-07-07,11226963384,125,121,3,18,2,5000551,140000,1090551,4050000,10921203384,305760000,2381763384,8845200000,243,243,243,243,5140551,243,4
وصنعت,2013-07-08,7666119318,79,113,1,11,1,3095658,280000,375658,3000000,7030239318,635880000,853119318,6813000000,252,252,252,252,3375658,252,3.98351648351648
وصنعت,2013-07-09,24933569517,245,201,7,16,4,9645597,915000,255596,10305001,22773254517,2160315000,603462156,24330107361,262,262,262,262,10560597,262,3.96301188903567
وصنعت,2013-07-10,5896514745,74,55,5,32,2,1919339,482500,1396839,1005000,4711977245,1184537500,3429239745,2467275000,273,273,273,273,2401839,273,3.98136382888606
وصنعت,2013-07-13,159016313234,3002,556,30,680,18,27114269,35313956,57966945,4461280,68978565233,90037748001,147676747328,11339565906,284,275,284,278,62428225,283,3.74745417515275
وصنعت,2013-07-14,28936084449,663,191,8,242,4,7948806,3830000,11186086,592720,19495781275,9440303174,27485791329,1450293120,282,272,273,277,11778806,273,-3.53356890459364
وصنعت,2013-07-15,31051239259,572,224,9,149,3,11283731,880968,11364699,800000,28800366019,2250873240,29007239259,2044000000,284,278,281,284,12164699,284,3.90720390720391
وصنعت,2013-07-16,73296756091,2063,834,11,244,11,25506442,2237000,15768823,11974619,67390724217,5906031874,41599647591,31697108500,295,275,292,295,27743442,294,3.48609479044262
وصنعت,2013-07-17,25974581788,1180,518,1,218,7,9532520,253287,8586749,1199058,25306336978,668244810,22784755473,3189826315,300,283,294,296,9785807,295,0.454201362604088
وصنعت,2013-07-20,21063243293,874,367,6,190,5,6636289,1269713,7197095,708907,17677052612,3386190681,19160054299,1903188994,305,285,302,285,7906002,296,0.376789751318764
وصنعت,2013-07-21,31257132292,1125,319,2,250,5,10254020,1910000,10619164,1544856,26365632292,4891500000,27284035337,3973096955,294,284,289,284,12164020,286,-3.52852852852853
وصنعت,2013-07-22,34931454002,1238,328,3,354,4,11166453,2355373,13230858,290968,28800894703,6130559299,34178043978,753410024,297,275,289,297,13521826,287,0.505836575875486
وصنعت,2013-07-23,14048086204,153,85,0,30,1,5230114,0,230114,5000000,14048086204,0,618086204,13430000000,298,298,298,298,5230114,298,3.98761130468448
وصنعت,2013-07-24,5100012414,70,54,0,35,0,1825998,0,1825998,0,5100012414,0,5100012414,0,310,310,310,310,1825998,310,3.98361876396128
وصنعت,2013-07-27,44634864314,1292,550,14,311,11,12197377,3700000,12367004,3530373,34120455039,10514409275,34661405936,9973458378,321,299,321,301,15897377,312,0.537056928034372
وصنعت,2013-07-28,12865869881,568,205,2,162,1,4061984,650000,4671884,40100,11077282751,1788587130,12755514681,110355200,311,300,305,302,4711984,303,-2.77777777777778
وصنعت,2013-07-29,17172004002,805,324,5,197,1,4760371,1317500,5377871,700000,13434300177,3737703825,15185911002,1986093000,316,304,304,309,6077871,314,3.47985347985348
وصنعت,2013-07-31,22837819793,802,272,3,259,1,7485148,477192,7862340,100000,21501382193,1336437600,22547819793,290000000,326,305,317,325,7962340,319,1.52212389380531
وصنعت,2013-08-03,27671574689,884,374,1,184,9,9018720,300000,5248720,4070000,26776974689,894600000,15595430379,12076144310,331,320,331,320,9318720,330,3.52161785216179
وصنعت,2013-08-04,4927306180,339,112,2,78,0,1424327,300000,1724327,0,4071973348,855332832,4927306180,0,322,317,322,317,1724327,318,-3.73863253620748
وصنعت,2013-08-05,7322289273,270,96,0,116,0,2659192,0,2659192,0,7322289273,0,7322289273,0,317,305,306,305,2659192,306,-3.63890832750175
وصنعت,2013-08-06,12135306108,500,146,0,209,2,4550873,0,4325873,225000,12135306108,0,11534638108,600668000,305,294,294,297,4550873,296,-3.15904139433551
وصنعت,2013-08-07,12053230966,670,266,2,147,0,3623290,996409,4619699,0,9449730849,2603500117,12053230966,0,303,285,303,285,4619699,290,-2.17472815898013
وصنعت,2013-08-11,10863733075,635,239,4,158,2,3802343,490000,3360732,931611,9622115367,1241617708,8511054666,2352678409,293,278,293,278,4292343,281,-2.98965120735914
وصنعت,2013-08-12,12857466037,460,158,4,183,1,2896602,2048772,4845374,100000,7492435925,5365030112,12595666037,261800000,292,272,278,292,4945374,289,2.72619517977084
وصنعت,2013-08-13,5249129510,131,44,4,76,0,1295987,646417,1942404,0,3503658648,1745470862,5249129510,0,301,296,301,301,1942404,300,3.92307692307692
وصنعت,2013-08-14,32151415661,978,258,10,319,5,7158111,4397431,8018737,3536805,19892532642,12258883019,22276014053,9875401608,312,291,300,300,11555542,309,2.96076980014804
وصنعت,2013-08-17,32175378028,908,104,5,306,6,2307595,9042575,8194621,3155549,6469898808,25705479220,23309033372,8866344656,322,303,306,309,11350170,315,1.90510424155284
وصنعت,2013-08-18,6232048612,215,60,2,99,0,700440,1586953,2287393,0,1912362546,4319686066,6232048612,0,311,303,311,303,2287393,303,-3.88007054673721
وصنعت,2013-08-19,6095822506,359,95,1,127,2,2165866,100000,2165866,100000,5819122506,276700000,5824556532,271265974,310,291,296,292,2265866,299,-1.28440366972477
وصنعت,2013-08-20,4414632068,248,104,0,81,0,1673556,0,1673556,0,4414632068,0,4414632068,0,302,287,295,287,1673556,293,-1.93308550185874
وصنعت,2013-08-21,10701655771,460,150,3,203,3,3652397,400000,3922397,130000,9627611498,1074044273,10362686256,338969515,305,282,282,305,4052397,293,0.113722517058378
وصنعت,2013-08-24,2060488560,24,13,1,9,1,700000,50360,26532,723828,1922200000,138288560,72856872,1987631688,305,305,305,305,750360,305,3.97576675501704
وصنعت,2013-08-25,2210695020,40,16,1,25,1,674324,100000,125323,649001,1925195020,285500000,357797165,1852897855,317,317,317,317,774324,317,3.96941005098325
وصنعت,2013-08-26,100641611961,1665,668,11,446,11,31579887,2347000,12426527,21500360,93673701655,6967910306,36850131761,63791480200,330,323,330,330,33926887,330,3.88791593695271
وصنعت,2013-08-27,39480279956,1474,503,3,272,10,13121793,200001,8267424,5054370,38899926885,580353071,24627114648,14853165308,342,317,332,317,13321794,329,-0.067430883344572
وصنعت,2013-08-28,138523358,21,18,0,1,0,48673,0,48673,0,138523358,0,138523358,0,316,316,316,316,48673,329,-0.269905533063428
وصنعت,2013-08-31,2171688684,39,20,1,8,0,65218,700000,765218,0,185088684,1986600000,2171688684,0,315,315,315,315,765218,315,-3.99188092016238
وصنعت,2013-09-01,25042968822,755,227,3,267,2,8683164,407000,8944664,145500,23916520176,1126448646,24639829822,403139000,313,303,303,303,9090164,306,-2.9245947850599
وصنعت,2013-09-03,6162918606,227,116,3,59,0,2126009,170000,2296009,0,5708785206,454133400,6162918606,0,311,294,303,294,2296009,298,-2.57713248638838
وصنعت,2013-09-04,161719635,17,16,0,1,0,62755,0,62755,0,161719635,0,161719635,0,286,286,286,286,62755,297,-0.33532041728763
وصنعت,2013-09-07,1925280960,31,12,1,9,1,49720,700000,649720,100000,127680960,1797600000,1668480960,256800000,285,285,285,285,749720,285,-4
وصنعت,2013-09-08,13061356865,377,141,0,130,1,5291826,0,4031216,1260610,13061356865,0,9952067280,3109289585,285,274,274,274,5291826,274,-3.89408099688474
وصنعت,2013-09-09,12135486178,600,227,0,146,0,4872058,0,4872058,0,12135486178,0,12135486178,0,282,268,280,274,4872058,277,0.93192868719611
وصنعت,2013-09-10,3488703630,105,54,1,45,0,1251307,100000,1351307,0,3229703630,259000000,3488703630,0,288,277,288,288,1351307,287,3.65315134484143
وصنعت,2013-09-11,13330425088,400,180,1,116,1,4896981,100000,4296981,700000,13061925088,268500000,11450925088,1879500000,298,290,298,295,4996981,296,3.33075135553834
وصنعت,2013-09-14,12075142668,407,152,0,89,2,4700878,0,4660378,40500,12075142668,0,11970806602,104336066,296,285,292,285,4700878,285,-3.71064467766117
وصنعت,2013-09-15,12444554932,494,149,2,193,1,4297356,400000,4397356,300000,11397554932,1047000000,11666288404,778266528,297,286,296,289,4697356,294,3.11405216037369
وصنعت,2013-09-16,4013023422,213,73,0,77,2,1546055,0,1444555,101500,4013023422,0,3750122422,262901000,296,284,296,289,1546055,288,-2.0007550018875
وصنعت,2013-09-17,6627979688,331,82,2,133,0,1961083,600000,2561083,0,5137623128,1577988658,6715611786,0,298,285,285,285,2526891,291,1.04006163328197
وصنعت,2013-09-18,11275786380,258,36,2,120,2,3394380,760000,3064163,1090217,9208118891,2067667489,8302864621,2972921759,303,293,297,303,4154380,302,3.46930995043843
وصنعت,2013-09-21,17837322098,540,181,4,158,2,4560269,1766000,6222269,104000,12858324112,4978997986,17543834098,293488000,314,306,314,313,6326269,313,3.90567428150332
وصنعت,2013-09-22,7466566996,391,114,3,172,1,2086100,600000,2683100,3000,5796567209,1669999787,7458427996,8139000,320,301,317,319,2686100,309,-1.41843971631206
وصنعت,2013-09-23,12252383193,355,115,4,160,4,3487425,755000,2691148,1551277,10074867363,2177515830,7775081989,4477301204,321,312,313,321,4242425,321,3.88489208633093
وصنعت,2013-09-24,8340133667,360,121,2,115,1,1769109,1150000,2912109,7000,5036159631,3303974036,8320163119,19970548,326,310,326,311,2919109,318,-1.07340720221607
وصنعت,2013-09-25,9690608361,437,138,5,129,2,2119066,1300000,3349957,69109,6008487690,3682120671,9494166881,196441480,323,305,316,309,3419066,315,-0.805040252012601
وصنعت,2013-09-28,15745694490,591,146,3,250,4,4670723,700000,3999848,1370875,13683017293,2062677197,11734535515,4011158975,328,318,328,328,5370723,326,3.45800988002823
وصنعت,2013-09-29,13237472286,629,175,2,177,2,3430375,1196708,4108490,518593,9844257381,3393214905,11751455173,1486017113,328,313,327,313,4627083,318,-2.42155525238745
وصنعت,2013-09-30,7398838612,446,184,1,105,3,2653341,7000,2244181,416160,7379217612,19621000,6242218877,1156619735,316,305,314,310,2660341,309,-2.79622509612024
وصنعت,2013-10-01,5715945900,268,96,1,84,0,1839979,200000,2039979,0,5155345900,560600000,5715945900,0,317,305,313,310,2039979,311,0.75512405609493
وصنعت,2013-10-02,6140177633,323,119,1,127,1,2055676,100000,1955676,200000,5852627633,287550000,5569129288,571048345,321,306,310,316,2155676,317,1.64168451106353
وصنعت,2013-10-05,7358313042,354,137,1,98,3,1973737,644154,2225694,392197,5544528627,1813784415,6256686918,1101626124,323,309,322,311,2617891,312,-1.29915730337079
وصنعت,2013-10-06,10460024275,425,143,4,141,1,2601697,1143482,2845179,900000,7257135602,3202888673,7956298944,2503725331,317,308,311,315,3745179,310,-0.64034151547492
وصنعت,2013-10-07,6930259177,299,86,2,114,1,1986644,482838,2465942,3540,5584715112,1345544065,6920310537,9948640,316,309,316,314,2469482,312,0.465449337629789
وصنعت,2013-10-08,5619526931,215,42,3,130,1,1243285,744813,1788098,200000,3513367522,2106159409,5050326931,569200000,317,310,316,315,1988098,314,0.74839629365645
وصنعت,2013-10-09,28086743857,930,98,9,324,6,2838509,6749339,8404008,1183840,8318844092,19767899765,24620339573,3466404284,327,313,316,327,9587848,326,3.60806508666431
وصنعت,2013-10-12,23921425091,764,218,9,232,10,4503560,3380000,5915695,1967865,13660923574,10260501517,17936658946,5984766145,339,328,328,339,7883560,337,3.58484124274496
وصنعت,2013-10-13,10783463075,542,193,5,172,1,2309700,1260000,3545200,24500,6950800809,3832662266,10708881651,74581424,350,324,346,325,3569700,336,-0.428477257745551
وصنعت,2013-10-14,8809624950,276,94,3,96,1,2096451,932923,2929374,100000,6095530000,2714094950,8518084699,291540251,328,322,328,322,3029374,323,-3.7404832836809
وصنعت,2013-10-15,12377657480,519,123,4,142,1,2077372,2176978,4054350,200000,6011542324,6366115156,11793657480,584000000,332,312,312,316,4254350,323,0.034387895460798
وصنعت,2013-10-19,26810014780,731,152,7,222,2,5262632,3710000,7772632,1200000,15755490805,11054523975,23233738996,3576275784,336,323,323,333,8972632,332,2.71570986593331
وصنعت,2013-10-20,11531513289,428,143,1,131,2,3396930,500000,2407933,1488997,10058107559,1473405730,7135072545,4396440744,335,322,335,331,3896930,329,-0.970548862115127
وصنعت,2013-10-21,14940708893,191,68,2,65,3,3855609,1000000,2049789,2805820,11863708893,3077000000,6307200753,8633508140,342,342,342,342,4855609,342,3.98783372761068
وصنعت,2013-10-22,7010761600,123,50,2,62,1,1990863,200000,1190863,1000000,6370761600,640000000,3810761600,3200000000,356,356,356,356,2190863,356,3.99740006499837
وصنعت,2013-10-23,113395079154,2563,1016,16,350,8,31284956,2832099,22905304,11211751,103973981806,9421097348,76101454333,37293624821,370,360,370,370,34117055,369,3.875
وصنعت,2013-10-26,46135356491,1822,595,10,355,9,12604530,1411803,10376332,3640001,41538031681,4597324810,34165485068,11969871423,379,355,378,355,14016333,366,-0.962695547533093
وصنعت,2013-10-27,5680861704,249,138,2,49,1,1440515,355898,1271737,524676,4555868126,1124993578,4022340196,1658521508,355,351,351,351,1796413,351,-3.94896719319563
وصنعت,2013-10-28,30346541725,1116,333,1,282,5,8935357,400000,6151878,3183479,29031504675,1315037050,19911389682,10435152043,365,348,349,365,9335357,361,2.81467425679949
وصنعت,2013-10-29,17386475973,778,261,2,166,3,5213165,90000,4493345,809820,17097473745,289002228,14722055313,2664420660,369,353,367,356,5303165,364,0.861273454321747
وصنعت,2013-10-30,19756810939,751,329,4,142,1,5469793,747411,4604243,1612961,17380868957,2375941982,14642814303,5113996636,360,350,355,352,6217204,353,-3.08020738029887
وصنعت,2013-11-02,18804106128,1019,433,3,153,1,5761995,361000,5649673,473322,17699280128,1104826000,17358231987,1445874141,356,339,356,339,6122995,341,-3.36689741976086
وصنعت,2013-11-03,12748791764,816,324,0,164,2,4156026,0,3819139,336887,12748791764,0,11715740798,1033050966,347,335,345,338,4156026,341,-0.097688049495278
وصنعت,2013-11-04,7725905569,542,234,1,149,2,2527969,4000,2400499,131470,7713825569,12080000,7321857879,404047690,345,333,343,338,2531969,339,-0.554106910039113
وصنعت,2013-11-05,8800800139,489,204,0,137,1,2844080,0,2452676,391404,8800800139,0,7588716636,1212083503,349,336,336,339,2844080,344,1.40937397574566
وصنعت,2013-11-06,13465824232,685,252,1,133,2,4067588,300000,4078099,289489,12540924558,924899674,12569290132,896534100,350,337,342,344,4367588,343,-0.355526826115061
وصنعت,2013-11-09,10642153669,604,265,0,136,1,3425320,0,2825320,600000,10642153669,0,8771886489,1870267180,355,339,355,341,3425320,345,0.778462536490431
وصنعت,2013-11-10,9042864010,587,282,2,127,1,2985478,16000,2940111,61367,8994549010,48315000,8858763010,184101000,345,332,344,333,3001478,335,-3.0254264563888
وصنعت,2013-11-11,7864048511,543,238,1,142,3,2611979,2000,2323546,290433,7858010511,6038000,6991313933,872734578,341,330,334,335,2613979,334,-0.16594756057086
وصنعت,2013-11-12,7300574588,514,205,2,129,0,2094017,317000,2411017,0,6339386242,961188346,7300574588,0,341,334,335,338,2411017,337,0.664893617021277
وصنعت,2013-11-16,12037434520,560,174,2,212,1,3339950,500000,3639950,200000,10465448168,1571986352,11407634520,629800000,350,340,342,350,3839950,348,3.5336856010568
وصنعت,2013-11-17,12343083141,682,259,1,211,2,3886392,21020,2857412,1050000,12276449741,66633400,9057832249,3285250892,360,343,355,350,3907412,351,0.76555023923445
وصنعت,2013-11-18,10017173338,641,184,1,155,0,2710466,500000,3210466,0,8455603503,1561569835,10017173338,0,352,346,352,346,3210466,347,-1.23456790123457
وصنعت,2013-11-19,8573892290,601,213,4,194,0,2540140,160000,2700140,0,8067867385,506024905,8573892290,0,358,348,351,349,2700140,353,1.76282051282051
وصنعت,2013-11-20,9828282336,712,295,0,161,1,3187934,0,2987934,200000,9828282336,0,9210684836,617597500,349,339,349,346,3187934,343,-2.89763779527559
وصنعت,2013-11-23,19764315322,692,175,2,236,3,5774703,400000,2944703,3230000,18484787651,1279527671,9409231322,10355084000,356,348,351,356,6174703,356,3.82744080441129
وصنعت,2013-11-24,9102767665,195,93,0,69,3,2734385,0,1034385,1700000,9102767665,0,3443467665,5659300000,370,370,370,370,2734385,370,3.99875039050297
وصنعت,2013-11-25,27900731416,1261,417,6,390,1,6618335,1791731,8360066,50000,22004301788,5896429628,27732881416,167850000,383,356,383,361,8410066,369,-0.330429558425954
وصنعت,2013-11-26,13635528560,661,197,1,231,1,4229816,5150,4164966,70000,13618997060,16531500,13407564178,227964382,362,354,360,358,4234966,358,-2.9535864978903
وصنعت,2013-11-27,14342903667,813,225,4,206,2,3421741,1039792,4140513,321020,10989022316,3353881351,13321545428,1021358239,362,349,356,361,4461533,357,-0.15527950310559
وصنعت,2013-11-30,14418350378,640,153,2,208,1,3431531,900000,4251531,80000,11416080243,3002270135,14153900378,264450000,372,364,366,372,4331531,370,3.54587869362364
وصنعت,2013-12-01,20094008126,1073,322,3,328,2,5665723,298477,5715607,248593,19089318952,1004689174,19254927452,839080674,383,362,382,362,5964200,374,1.20156203063983
وصنعت,2013-12-02,15321448196,645,234,4,152,1,3945429,770000,4515429,200000,12825126496,2496321700,14673268246,648179950,366,360,362,360,4715429,361,-3.56188780053428
وصنعت,2013-12-03,11066074979,705,259,1,123,2,3376071,100000,2482442,993629,10747074979,319000000,7912468228,3153606751,366,347,366,351,3476071,354,-2.00061557402278
وصنعت,2013-12-04,9104731036,384,141,2,97,2,2663691,200000,1284068,1579623,8469500012,635231024,4078727077,5026003959,358,350,358,353,2863691,353,-0.157035175879397
وصنعت,2013-12-07,7628480286,532,172,3,171,2,1425688,920000,1928392,417296,4632187468,2996292818,6272913857,1355566429,367,356,356,359,2345688,361,2.29631959735766
وصنعت,2013-12-08,9799609493,647,185,3,150,4,2505281,550000,2306482,748799,8025056050,1774553443,7399415269,2400194224,366,351,366,353,3055281,356,-1.38376383763838
وصنعت,2013-12-09,10545307973,655,237,2,146,1,3003221,337889,2589891,751219,9485681266,1059626707,8187340656,2357967317,356,347,356,348,3341110,351,-1.59027128157156
وصنعت,2013-12-10,10905549041,622,235,3,123,2,3309414,135000,1462658,1981756,10479231801,426317240,4639726117,6265822924,358,347,350,349,3444414,352,0.316856780735108
وصنعت,2013-12-11,33419214914,1091,198,7,316,4,5215412,5008590,6571721,3652281,16978955784,16440259130,21507597491,11911617423,366,350,358,366,10224002,363,3.25331648768162
وصنعت,2013-12-14,40509431586,1241,221,3,428,4,5042531,7096038,11171158,967411,16782357674,23727073912,37256981597,3252449989,378,349,357,378,12138569,371,2.08014683389416
وصنعت,2013-12-15,24263146311,1016,298,6,252,8,6040216,1039645,4503454,2576407,20710178748,3552967563,15437283415,8825862896,386,371,378,378,7079861,381,2.69703326341025
وصنعت,2013-12-16,22196007637,1015,264,2,338,6,4825955,1450000,5801767,474188,17051553595,5144454042,20513271311,1682736326,396,384,389,392,6275955,393,3.20980449372629
وصنعت,2013-12-17,14868998294,678,208,2,225,4,2518551,1790549,4029100,280000,8680838693,6188159601,13905076909,963921385,399,377,399,389,4309100,384,-2.43143907266045
وصنعت,2013-12-18,19805279543,622,145,1,252,5,2045006,3559836,3640218,1964624,7228780124,12576499419,12845238545,6960040998,398,383,391,390,5604842,393,2.40509997102289
وصنعت,2013-12-21,11432614647,464,147,1,172,2,978075,2300000,3169671,108404,3405387185,8027227462,11049542437,383072210,398,379,398,384,3278075,388,-1.30164119977363
وصنعت,2013-12-22,7399892502,476,142,2,124,0,1563868,603900,2167768,0,5329879279,2070013223,7399892502,0,388,372,387,372,2167768,379,-2.12155963302752
وصنعت,2013-12-24,8653152668,476,157,2,144,0,2424044,101000,2525044,0,8307752668,345400000,8653152668,0,387,377,383,380,2525044,381,0.380785002929115
وصنعت,2013-12-25,15174222459,681,187,2,246,3,4101648,280480,4235801,146327,14206030656,968191803,14663956116,510266343,390,378,378,385,4382128,385,1.05048147067406
وصنعت,2013-12-30,7804533068,320,97,2,144,3,1587676,654692,2041368,201000,5519423570,2285109498,7101034068,703499000,391,381,389,383,2242368,387,0.490903840600635
وصنعت,2014-01-01,11992589262,565,159,3,215,3,2351962,1132119,2452121,1031960,8094495984,3898093278,8470978936,3521610326,396,374,389,378,3484081,383,-1.09195402298851
وصنعت,2014-01-04,11684162021,545,171,2,146,4,3175817,280000,1428542,2027275,10747692308,936469713,4861388079,6822773942,387,368,383,369,3455817,376,-1.77222545031958
وصنعت,2014-01-05,10865258448,488,182,3,128,4,2491675,770000,2329675,932000,8307890043,2557368405,7764511108,3100747340,376,368,372,369,3261675,370,-1.47885241052943
وصنعت,2014-01-06,20289848179,594,137,5,198,6,4902928,1000000,3669909,2233019,16858326090,3431522089,12603531780,7686316399,385,373,380,385,5902928,382,3.1822275592915
وصنعت,2014-01-07,17634505856,724,160,5,233,3,3146540,1889000,3525697,1509843,10993248631,6641257225,12355845344,5278660512,394,382,393,385,5035540,389,1.89118417224324
وصنعت,2014-01-08,8297925179,389,85,2,159,1,1071001,1325229,2363231,32999,3696589397,4601335782,8182329682,115595497,390,379,389,383,2396230,385,-1.11364934323244
وصنعت,2014-01-11,6413094076,312,79,1,133,1,1644229,200000,1832229,12000,5719596826,693497250,6371454076,41640000,396,378,389,379,1844229,386,0.404273751082876
وصنعت,2014-01-12,8863678243,221,64,2,89,3,1061604,1589600,2201204,450000,3557593443,5306084800,7361280023,1502398220,382,371,382,376,2651204,372,-3.85389703767616
وصنعت,2014-01-13,7671119903,318,118,0,88,4,2247974,0,1724842,523132,7671119903,0,5889377124,1781742779,382,376,382,379,2247974,379,2.06401435836075
وصنعت,2014-01-14,5502473432,300,90,3,80,1,1248732,404771,1563503,90000,4167153670,1335319762,5207047335,295426097,383,364,378,369,1653503,370,-2.46189917936694
وصنعت,2014-01-15,7029025908,242,78,1,87,2,1128006,1000000,1883426,244580,3710953526,3318072382,6221184702,807841206,371,357,361,366,2128006,367,-0.751201923076923
وصنعت,2014-01-18,2337004512,288,72,1,91,1,559469,160000,714049,5420,1813975785,523028727,2319285712,17718800,376,356,363,361,719469,361,-1.60460187708144
وصنعت,2014-01-20,3066080166,146,65,1,31,0,940563,38175,978738,0,2945541453,120538713,3066080166,0,368,347,368,347,978738,348,-3.6
وصنعت,2014-01-21,11223847527,348,78,2,120,3,2713598,793000,3059912,446686,8734079737,2489767790,9775679239,1448168288,362,339,339,351,3506598,356,2.1704436642196
وصنعت,2014-01-22,3308118510,224,78,1,88,2,1059228,10000,965085,104143,3277293510,30825000,2984644796,323473714,351,342,347,345,1069228,344,-3.34270540456107
وصنعت,2014-01-25,3252151734,323,79,0,82,0,1047276,0,1047276,0,3252151734,0,3252151734,0,354,330,349,349,1047276,345,0.355526826115061
وصنعت,2014-01-26,6439147549,346,120,4,84,0,1424011,720000,2144011,0,4291639269,2147508280,6439147549,0,352,331,352,331,2144011,334,-3.28502415458937
وصنعت,2014-01-27,5002533903,173,66,2,80,0,1333459,400000,1733459,0,3849333903,1153200000,5002533903,0,328,320,320,328,1733459,321,-3.8961038961039
وصنعت,2014-01-28,6077604562,262,90,1,76,1,2020677,5000,1825677,200000,6062604562,15000000,5477404562,600200000,334,331,334,334,2025677,333,3.95010395010395
وصنعت,2014-01-29,1479630523,79,18,1,51,0,470498,5000,475498,0,1464030523,15600000,1479630523,0,347,339,340,347,475498,341,2.36666666666667
وصنعت,2014-02-01,4025357626,137,81,0,34,0,1260682,0,1260682,0,4025357626,0,4025357626,0,355,355,355,355,1260682,355,3.97264734614132
وصنعت,2014-02-02,4629797647,252,93,0,84,0,1475789,0,1475789,0,4629797647,0,4629797647,0,362,343,357,346,1475789,349,-1.75383651738177
وصنعت,2014-02-03,1132292931,136,54,0,50,0,366249,0,366249,0,1132292931,0,1132292931,0,351,336,342,349,366249,346,-0.701306981192222
وصنعت,2014-02-04,2644034450,156,63,2,42,0,660260,195000,855260,0,2042034450,602000000,2644034450,0,356,334,352,338,855260,344,-0.770465489566613
وصنعت,2014-02-05,5153255275,222,70,0,63,1,1733754,0,1730757,2997,5153255275,0,5144273266,8982009,334,330,333,330,1733754,330,-3.84988676803623
وصنعت,2014-02-08,2859752036,158,58,0,62,0,1002009,0,1002009,0,2859752036,0,2859752036,0,318,317,317,317,1002009,317,-3.97039030955585
وصنعت,2014-02-09,2454131910,202,66,2,65,0,820593,40770,861363,0,2337888572,116243338,2454131910,0,322,307,307,320,861363,317,-0.175192711983182
وصنعت,2014-02-10,3170401390,195,35,0,61,1,1121599,0,1116599,5000,3170401390,0,3156396390,14005000,328,311,325,311,1121599,314,-0.772200772200772
وصنعت,2014-02-12,3823172267,128,41,0,37,0,1400294,0,1400294,0,3823172267,0,3823172267,0,312,302,312,302,1400294,303,-3.43119915104351
وصنعت,2014-02-15,1402968380,96,43,1,42,1,503104,1000,454104,50000,1400268380,2700000,1265200572,137767808,315,298,308,307,504104,307,1.31868131868132
وصنعت,2014-02-16,714957420,79,32,0,37,0,251204,0,251204,0,714957420,0,714957420,0,320,301,301,320,251204,310,0.976138828633406
وصنعت,2014-02-17,4796832520,201,81,0,74,1,1652867,0,1602867,50000,4796832520,0,4651632520,145200000,323,306,323,323,1652867,323,3.90261367704977
وصنعت,2014-02-18,2692208673,178,45,0,85,1,905907,0,855907,50000,2692208673,0,2541308673,150900000,335,312,330,335,905907,330,2.41212956581668
وصنعت,2014-02-19,3568925280,42,17,0,13,2,1154992,0,148992,1006000,3568925280,0,460385280,3108540000,343,343,343,343,1154992,343,3.97039030955585
وصنعت,2014-02-22,16974273391,298,172,0,37,4,5291377,0,505474,4785903,16974273391,0,1611494142,15362779249,357,351,357,351,5291377,357,3.81877022653722
وصنعت,2014-02-23,7009238335,474,148,0,155,2,2179626,0,2123226,56400,7009238335,0,6826350316,182888019,364,351,361,357,2179626,357,0.249376558603491
وصنعت,2014-02-24,2274670748,200,79,1,59,1,717039,8250,675289,50000,2248773998,25896750,2117663648,157007100,353,345,353,349,725289,349,-2.39427860696517
وصنعت,2014-02-25,2995497229,278,112,1,66,0,982701,2000,984701,0,2989467229,6030000,2995497229,0,348,335,348,338,984701,338,-3.090156100669
وصنعت,2014-02-26,1648414349,224,90,0,64,1,546868,0,533940,12928,1648414349,0,1609320077,39094272,339,328,339,336,546868,336,-0.657462195923734
وصنعت,2014-03-01,6040604251,258,96,0,71,4,1922549,0,1639677,282872,6040604251,0,5151820427,888783824,349,349,349,349,1922549,349,3.97088021178028
وصنعت,2014-03-02,3057070650,275,80,1,85,1,976344,1075,927419,50000,3053738150,3332500,2900054744,157015906,355,342,355,348,977419,348,-0.445576066199873
وصنعت,2014-03-03,2576715908,262,85,1,79,2,847437,1900,785337,64000,2570960808,5755100,2382363679,194352229,347,335,345,337,849337,337,-3.00511508951407
وصنعت,2014-03-04,4817982939,302,92,0,67,3,1589872,0,1058036,531836,4817982939,0,3209042964,1608939975,341,332,337,337,1589872,337,-0.1318391562294
وصنعت,2014-03-05,7643895367,351,84,1,104,3,2031088,400000,1378386,1052702,6383495367,1260400000,4331213485,3312681882,350,337,348,349,2431088,349,3.76237623762376
وصنعت,2014-03-08,1915937076,178,52,1,48,1,416290,200000,613290,3000,1297937076,618000000,1906697076,9240000,354,341,354,342,616290,346,-0.922391857506361
وصنعت,2014-03-09,2686708535,179,53,2,62,1,633598,248494,782092,100000,1930617251,756091284,2382347621,304360914,340,337,339,338,882092,339,-2.21508828250401
وصنعت,2014-03-10,5886385969,265,88,2,87,0,1035156,910000,1945156,0,3114636645,2771749324,5886385969,0,342,325,325,333,1945156,336,-0.656598818122127
وصنعت,2014-03-11,12304667696,662,98,1,156,2,1100941,3000000,3909754,191187,3278683844,9025983852,11731061696,573606000,340,325,328,333,4100941,333,-0.859220092531394
وصنعت,2014-03-16,1309253920,90,40,0,29,1,460230,0,458730,1500,1309253920,0,1304903920,4350000,379,364,379,364,460230,372,11.5686274509804
وصنعت,2014-03-17,3343254948,75,30,3,15,1,270439,953300,1123739,100000,738839348,2604415600,3070054948,273200000,357,357,357,357,1223739,357,-3.97188049209139
وصنعت,2014-03-18,8946750228,622,239,1,93,2,3295797,53386,2747304,601879,8805873684,140876544,7367629833,1579120395,364,343,356,345,3349183,349,-2.23279648609078
وصنعت,2014-03-19,5170167912,327,104,0,120,0,1936168,0,1936168,0,5170167912,0,5170167912,0,361,340,352,361,1936168,349,-0.037439161362786
وصنعت,2014-03-25,1080991090,125,51,0,47,0,401162,0,401162,0,1080991090,0,1080991090,0,360,347,360,354,401162,351,0.48689138576779
وصنعت,2014-03-26,3112813406,342,74,0,39,1,1181573,0,781573,400000,3112813406,0,2050812406,1062001000,359,337,359,339,1181573,344,-1.8263138278047
وصنعت,2014-03-29,883703775,96,41,0,33,1,343989,0,319089,24900,883703775,0,819059585,64644190,345,331,335,335,343989,340,-1.13895216400911
وصنعت,2014-03-30,1945922989,136,63,1,42,1,721720,20000,463320,278400,1893922989,52000000,1212441491,733481498,350,336,346,341,741720,343,0.729646697388633
وصنعت,2014-03-31,1411916368,138,45,1,55,0,535297,1000,536297,0,1409306368,2610000,1411916368,0,348,340,343,340,536297,344,0.266869996187571
وصنعت,2014-04-05,2639356989,158,34,0,73,1,1008387,0,991294,17093,2639356989,0,2594487864,44869125,345,338,340,344,1008387,342,-0.494296577946768
وصنعت,2014-04-06,2678011418,159,50,2,61,0,800627,246862,1047489,0,2052391318,625620100,2678011418,0,349,329,349,337,1047489,334,-2.2927015666794
وصنعت,2014-04-08,3901887338,233,68,1,100,2,1289066,200000,1449066,40000,3374487338,527400000,3797132738,104754600,345,335,335,341,1489066,343,3.31230283911672
وصنعت,2014-04-09,1358859125,104,42,0,36,1,532543,0,518058,14485,1358859125,0,1322020831,36838294,346,331,339,333,532543,336,-1.87022900763359
وصنعت,2014-04-13,2164933776,162,46,1,60,0,861625,50000,911625,0,2046233776,118700000,2164933776,0,335,310,335,310,911625,311,-3.92394822006472
وصنعت,2014-04-14,1749711092,86,42,1,28,1,402057,350000,402057,350000,916711092,833000000,916711092,833000000,311,298,298,298,752057,304,-2.02105263157895
وصنعت,2014-04-15,2156321857,172,62,0,69,2,928169,0,847277,80892,2156321857,0,1967227977,189093880,316,292,292,305,928169,304,-0.171895143962183
وصنعت,2014-04-16,1087237595,132,50,1,51,0,395130,70000,465130,0,920912517,166325078,1087237595,0,314,298,305,307,465130,305,0.387430047352561
وصنعت,2014-04-19,450966609,37,24,0,10,0,200463,0,200463,0,450966609,0,450966609,0,299,293,299,293,200463,302,-0.943396226415094
وصنعت,2014-04-20,593452258,89,43,0,34,0,257356,0,257356,0,593452258,0,593452258,0,310,296,310,299,257356,302,-0.043290043290043
وصنعت,2014-04-21,8316143442,546,245,1,97,3,3390904,316871,2056139,1651636,7585545944,730597498,4641846087,3674297355,305,290,294,305,3707775,293,-2.85838025119099
وصنعت,2014-04-22,3469850502,277,101,0,106,4,1495148,0,1128401,366747,3469850502,0,2616394698,853455804,305,297,305,299,1495148,303,3.47748551047704
وصنعت,2014-04-23,1126002814,105,41,0,47,1,490782,0,390782,100000,1126002814,0,897230501,228772313,305,295,298,300,490782,301,-0.732442912537699
وصنعت,2014-04-26,4752922139,253,76,0,94,2,1990082,0,1590082,400000,4752922139,0,3794522139,958400000,313,303,312,313,1990082,312,3.64583333333333
وصنعت,2014-04-27,3767006034,232,76,1,86,1,1261682,300000,1561681,1,3037230920,729775114,3767003629,2405,321,307,320,307,1561682,315,1.00502512562814
وصنعت,2014-04-28,1325589775,103,38,0,41,1,564824,0,425539,139285,1325589775,0,996612338,328977437,311,303,307,308,564824,309,-2.03150912106136
وصنعت,2014-04-29,2042153292,136,57,1,46,0,755615,129850,885465,0,1746192770,295960522,2042153292,0,311,297,309,298,885465,301,-2.41218789674143
وصنعت,2014-04-30,1195453100,101,44,0,41,1,521009,0,464068,56941,1195453100,0,1064147154,131305946,307,290,291,303,521009,300,-0.346921075455334
وصنعت,2014-05-03,1329244482,128,49,0,38,1,585324,0,580324,5000,1329244482,0,1317544482,11700000,307,294,299,296,585324,298,-0.913838120104439
وصنعت,2014-05-04,1335068284,110,22,1,41,0,568140,21992,590132,0,1285253980,49814304,1335068284,0,302,294,301,297,590132,296,-0.527009222661397
وصنعت,2014-05-05,794097380,75,20,1,29,1,224741,123395,334533,13603,513690730,280406650,762538420,31558960,303,296,296,297,348136,297,0.309050772626932
وصنعت,2014-05-06,1217986429,141,23,1,43,0,434217,100000,534217,0,989986429,228000000,1217986429,0,301,297,301,297,534217,298,0.264084507042253
وصنعت,2014-05-07,1305159495,98,46,1,40,0,554763,27069,581832,0,1245337005,59822490,1305159495,0,301,289,297,293,581832,294,-1.18525021949078
وصنعت,2014-05-10,972704534,88,38,1,35,0,394677,41000,435677,0,880780534,91924000,972704534,0,297,288,291,290,435677,293,-0.488671701466015
وصنعت,2014-05-11,948682182,83,17,1,25,0,426162,305,426467,0,948010572,671610,948682182,0,294,288,288,292,426467,292,-0.401785714285714
وصنعت,2014-05-12,1175382825,81,37,1,28,0,527556,3500,531056,0,1167640825,7742000,1175382825,0,297,287,297,290,531056,290,-0.582698341550874
وصنعت,2014-05-14,3110001749,180,53,3,60,0,688250,720337,1408587,0,1510687237,1599314512,3110001749,0,292,283,287,292,1408587,289,-0.450856627592426
وصنعت,2014-05-17,1356284272,149,58,0,39,0,639100,0,639100,0,1356284272,0,1356284272,0,279,277,277,277,639100,279,-3.30615942028985
وصنعت,2014-05-18,1633263513,201,48,0,42,0,758240,0,758240,0,1633263513,0,1633263513,0,285,277,282,282,758240,282,0.889929742388759
وصنعت,2014-05-19,943554873,96,26,1,48,0,145678,291168,436846,0,315429171,628125702,943554873,0,286,281,283,284,436846,282,0.139275766016713
وصنعت,2014-05-20,1859653508,115,33,0,35,1,862100,0,462100,400000,1859653508,0,997157532,862495976,285,273,278,282,862100,282,0
وصنعت,2014-05-21,2130108253,153,40,1,53,0,963073,1500,964573,0,2126823253,3285000,2130108253,0,293,278,286,293,964573,289,2.3643949930459
وصنعت,2014-05-24,4314330555,200,55,2,97,0,1413608,466630,1880238,0,3243121196,1071209359,4314330555,0,300,296,299,300,1880238,300,3.94021739130435
وصنعت,2014-05-25,1654440272,137,27,1,60,1,706919,23536,655577,74878,1601484272,52956000,1485215992,169224280,301,290,299,294,730455,296,-1.2636165577342
وصنعت,2014-05-26,1414322400,168,29,1,92,0,605921,19834,625755,0,1370033608,44288792,1414322400,0,301,291,294,297,625755,296,-0.220653133274492
وصنعت,2014-05-28,1553838004,131,26,0,53,0,693849,0,693849,0,1553838004,0,1553838004,0,300,290,298,291,693849,293,-0.884564352056612
وصنعت,2014-05-31,2009893903,171,25,1,47,0,804211,90000,894211,0,1807483903,202410000,2009893903,0,301,293,293,293,894211,294,0.312360553324409
وصنعت,2014-06-01,2791584923,239,22,0,69,1,1257777,0,1035719,222058,2791584923,0,2294175003,497409920,299,287,299,289,1257777,290,-1.29003558718861
وصنعت,2014-06-02,904649790,85,30,0,33,1,415290,0,237348,177942,904649790,0,518160352,386489438,289,284,289,286,415290,287,-1.03650292924741
وصنعت,2014-06-03,1406681746,80,21,0,27,1,641050,0,231050,410000,1406681746,0,510526288,896155458,294,284,294,290,641050,287,-0.045537340619308
وصنعت,2014-06-07,1330787730,156,25,0,36,0,610806,0,610806,0,1330787730,0,1330787730,0,288,284,288,284,610806,285,-0.592255125284738
وصنعت,2014-06-08,1281383404,112,31,0,30,1,584692,0,483430,101262,1281383404,0,1059289804,222093600,290,282,284,285,584692,286,0.320806599450046
وصنعت,2014-06-09,488353494,103,33,0,28,0,224038,0,224038,0,488353494,0,488353494,0,293,284,292,286,224038,286,-0.137048880767474
وصنعت,2014-06-10,1016688758,94,17,0,33,0,466088,0,466088,0,1016688758,0,1016688758,0,289,283,286,283,466088,285,-0.137236962488564
وصنعت,2014-06-11,646361202,58,22,0,18,0,299789,0,299789,0,646361202,0,646361202,0,288,279,288,280,299789,284,-0.503893724232707
وصنعت,2014-06-14,555894123,46,26,0,12,0,264872,0,264872,0,555894123,0,555894123,0,279,273,279,273,264872,281,-1.19705340699816
وصنعت,2014-06-15,1012736588,109,22,1,29,0,191128,300000,491128,0,394436588,618300000,1012736588,0,271,269,271,269,491128,273,-2.56290773532153
وصنعت,2014-06-16,718394480,79,40,0,26,0,346336,0,346336,0,718394480,0,718394480,0,275,263,263,269,346336,272,-0.38259206121473
وصنعت,2014-06-17,439869106,37,25,0,14,0,215270,0,215270,0,439869106,0,439869106,0,275,263,263,266,215270,271,-0.528084493518963
وصنعت,2014-06-18,1299728095,122,35,1,55,0,441857,166430,608287,0,941543621,358184474,1299728095,0,282,265,265,282,608287,278,2.50965250965251
وصنعت,2014-06-21,576870878,63,27,0,39,0,267007,0,267007,0,576870878,0,576870878,0,287,278,281,283,267007,279,0.612052730696798
وصنعت,2014-06-22,1355702863,77,15,0,48,0,624986,0,624986,0,1355702863,0,1355702863,0,286,281,281,285,624986,283,1.26345343940103
وصنعت,2014-06-23,1069015755,73,13,0,33,0,493478,0,493478,0,1069015755,0,1069015755,0,286,281,285,281,493478,283,0.092421441774492
وصنعت,2014-06-24,258153988,35,18,0,6,0,123223,0,123223,0,258153988,0,258153988,0,275,273,275,273,123223,282,-0.554016620498615
وصنعت,2014-06-25,767538498,67,30,0,14,0,369871,0,369871,0,767538498,0,767538498,0,282,270,282,270,369871,277,-1.81058495821727
وصنعت,2014-06-28,606526612,76,24,0,33,0,296934,0,296934,0,606526612,0,606526612,0,279,266,279,266,296934,273,-1.37115839243499
وصنعت,2014-06-29,365504692,50,15,0,12,0,182123,0,182123,0,365504692,0,365504692,0,266,262,266,262,182123,270,-0.910834132310642
وصنعت,2014-06-30,385786655,37,17,0,16,0,194275,0,194275,0,385786655,0,385786655,0,261,260,260,260,194275,268,-1.01596516690856
وصنعت,2014-07-01,594219890,83,39,0,30,1,292558,0,287578,4980,594219890,0,583811690,10408200,275,257,267,271,292558,267,-0.293255131964809
وصنعت,2014-07-02,760282133,80,26,0,28,1,362533,0,319242,43291,760282133,0,669371033,90911100,276,263,263,274,362533,270,1.37254901960784
وصنعت,2014-07-05,2944416924,168,60,0,33,1,1373992,0,1372417,1575,2944416924,0,2941030674,3386250,281,275,277,281,1373992,280,3.62669245647969
وصنعت,2014-07-06,2472149444,117,34,0,41,0,1179294,0,1179294,0,2472149444,0,2472149444,0,288,269,288,274,1179294,274,-2.19318712085861
وصنعت,2014-07-07,601741542,46,24,0,13,0,290584,0,290584,0,601741542,0,601741542,0,275,268,268,268,290584,273,-0.477099236641221
وصنعت,2014-07-08,3443288771,160,38,1,48,0,1545046,50000,1595046,0,3334838771,108450000,3443288771,0,284,277,277,284,1595046,282,3.49952061361457
وصنعت,2014-07-09,1034267575,87,23,1,32,0,213556,267000,480556,0,457550839,576716736,1034267575,0,284,275,284,280,480556,282,-0.185270958777212
وصنعت,2014-07-12,878739211,102,25,1,35,0,380735,33000,413735,0,809053790,69685421,878739211,0,281,274,274,278,413735,280,-0.788863109048724
وصنعت,2014-07-13,1297433417,93,28,0,19,0,621583,0,621583,0,1297433417,0,1297433417,0,279,272,278,274,621583,274,-1.9644527595884
وصنعت,2014-07-14,615184085,55,19,0,28,0,291320,0,291320,0,615184085,0,615184085,0,279,271,271,278,291320,275,0.286259541984733
وصنعت,2014-07-15,910508817,79,19,0,31,0,425710,0,425710,0,910508817,0,910508817,0,281,276,278,277,425710,278,0.999048525214082
وصنعت,2014-07-16,3241436514,181,43,1,62,1,1345813,150000,1071318,424495,2920162507,321274007,2322485520,918950994,286,275,280,286,1495813,283,2.07253886010363
وصنعت,2014-07-20,1426598090,93,24,1,33,1,511594,150000,411594,250000,1103414396,323183694,886355713,540242377,288,277,288,279,661594,282,-0.415320719889248
وصنعت,2014-07-21,1266167528,68,28,0,26,0,587311,0,587311,0,1266167528,0,1266167528,0,286,278,283,282,587311,282,-0.092678405931418
وصنعت,2014-07-22,2335146935,121,36,1,38,1,890953,176709,881265,186397,1946142383,389004552,1928796675,406350260,290,280,280,287,1067662,286,1.4378478664193
وصنعت,2014-07-23,2970946699,156,37,3,54,1,900945,443979,1294924,50000,1992089550,978857149,2860306199,110640500,294,284,285,285,1344924,289,1.00594421582076
وصنعت,2014-07-26,2100751622,117,28,2,30,1,889377,76838,716715,249500,1933460285,167291337,1558248252,542503370,294,281,294,289,966215,284,-1.584427342689
وصنعت,2014-07-27,1166909893,90,31,0,38,0,526970,0,526970,0,1166909893,0,1166909893,0,293,288,293,292,526970,288,1.28794848206072
وصنعت,2014-07-28,977164625,91,27,0,33,0,437641,0,437641,0,977164625,0,977164625,0,293,290,292,293,437641,290,0.817438692098093
وصنعت,2014-08-02,1759853808,80,29,2,20,1,556395,248750,797145,8000,1216161728,543692080,1741933808,17920000,294,284,294,284,805145,286,-1.53153153153153
وصنعت,2014-08-03,332023016,37,15,0,10,1,153945,0,53945,100000,332023016,0,117188213,214834803,287,280,287,280,153945,285,-0.274473924977127
وصنعت,2014-08-04,236248119,41,16,0,16,0,107982,0,107982,0,236248119,0,236248119,0,289,282,282,285,107982,285,0.045871559633028
وصنعت,2014-08-05,667211739,49,20,0,16,0,307195,0,307195,0,667211739,0,667211739,0,287,281,284,284,307195,285,-0.183402109124255
وصنعت,2014-08-06,1298614510,80,19,1,20,1,587738,8145,595383,500,1280899135,17715375,1297514510,1100000,288,282,284,284,595883,285,0.091869545245751
وصنعت,2014-08-09,914373482,79,16,0,17,3,420741,0,166431,254310,914373482,0,362229450,552144032,288,282,288,284,420741,284,-0.137677833868747
وصنعت,2014-08-10,376349828,48,17,0,17,0,174565,0,174565,0,376349828,0,376349828,0,284,280,280,281,174565,284,-0.229779411764706
وصنعت,2014-08-11,653557323,73,22,0,15,1,301830,0,141071,160759,653557323,0,306335129,347222194,285,281,282,281,301830,284,-0.092123445416859
وصنعت,2014-08-12,1367081123,128,26,1,37,1,475853,159665,450517,185001,1023666591,343414532,969228973,397852150,284,279,282,284,635518,282,-0.691562932226833
وصنعت,2014-08-13,690802598,64,13,0,26,0,317043,0,317043,0,690802598,0,690802598,0,286,281,286,285,317043,283,0.510677808727948
وصنعت,2014-08-16,10477523665,1492,124,4,83,2,3847908,811410,4159888,499430,8651351165,1826172500,9356199325,1121324340,294,292,293,294,4659318,294,3.87990762124711
وصنعت,2014-08-17,6844883065,373,117,0,109,2,2986000,0,2945000,41000,6844883065,0,6749754065,95129000,305,295,304,299,2986000,300,1.91196087149844
وصنعت,2014-08-18,1156693600,149,46,0,43,1,511798,0,495606,16192,1156693600,0,1119452000,37241600,301,291,299,292,511798,297,-0.959860383944154
وصنعت,2014-08-19,2091769858,175,67,1,44,1,724452,229223,949867,3808,1588702590,503067268,2083389758,8380100,292,285,292,285,953675,287,-3.3920704845815
وصنعت,2014-08-20,2489113218,205,76,1,27,0,1138774,14319,1153093,0,2458499196,30614022,2489113218,0,288,279,288,281,1153093,282,-1.55038759689923
وصنعت,2014-08-23,2560518557,176,51,0,63,0,1184437,0,1184437,0,2560518557,0,2560518557,0,292,276,288,287,1184437,283,0.138953219082909
وصنعت,2014-08-24,1180913098,84,26,1,28,0,466295,77834,544129,0,1012314654,168598444,1180913098,0,287,280,287,285,544129,283,0.277520814061055
وصنعت,2014-08-25,825912504,76,22,1,26,0,266848,115000,381848,0,576959948,248952556,825912504,0,285,281,281,285,381848,283,-0.138376383763838
وصنعت,2014-08-26,1098872247,79,32,0,22,1,508054,0,498461,9593,1098872247,0,1077978693,20893554,285,281,285,282,508054,283,-0.046189376443418
وصنعت,2014-08-27,1185023672,91,22,1,39,0,510481,35037,545518,0,1109694122,75329550,1185023672,0,286,281,281,282,545518,284,0.277264325323475
وصنعت,2014-08-30,600127275,49,11,1,24,1,106919,172703,197805,81817,229677745,370449530,424067620,176059655,282,280,282,280,279622,283,-0.414746543778802
وصنعت,2014-08-31,548583505,54,22,1,18,0,206010,50366,256376,0,440699533,107883972,548583505,0,284,279,281,279,256376,282,-0.3239241092087
وصنعت,2014-09-01,798048183,79,25,1,28,1,369235,5000,224235,150000,787373183,10675000,481758363,316289820,284,275,280,279,374235,280,-0.510677808727948
وصنعت,2014-09-02,1193156693,75,31,0,24,1,563366,0,246495,316871,1193156693,0,527408453,665748240,282,275,281,282,563366,278,-0.886607559496034
وصنعت,2014-09-03,350077880,39,17,1,18,0,132110,31500,163610,0,282825380,67252500,350077880,0,286,277,286,280,163610,278,0.141242937853107
وصنعت,2014-09-06,1488473134,94,31,1,26,1,631747,68500,450247,250000,1342225634,146247500,953279950,535193184,280,275,280,275,700247,278,-0.047014574518101
وصنعت,2014-09-07,666613380,90,22,0,30,0,316806,0,316806,0,666613380,0,666613380,0,278,275,275,275,316806,277,-0.423330197554092
وصنعت,2014-09-08,672341931,62,16,2,20,0,311404,6017,317421,0,659646078,12695853,672341931,0,280,275,275,279,317421,277,0
وصنعت,2014-09-09,236690667,40,19,0,21,0,111279,0,111279,0,236690667,0,236690667,0,283,276,279,276,111279,277,0.04723665564478
وصنعت,2014-09-10,1176661990,60,21,0,19,0,554413,0,554413,0,1176661990,0,1176661990,0,280,275,276,278,554413,277,0.141643059490085
وصنعت,2014-09-13,519379489,39,11,0,10,0,247756,0,247756,0,519379489,0,519379489,0,277,273,275,274,247756,276,-0.377180575200377
وصنعت,2014-09-14,483654791,43,14,0,22,0,231444,0,231444,0,483654791,0,483654791,0,275,270,274,274,231444,275,-0.331282536677709
وصنعت,2014-09-15,421410307,47,19,2,19,0,142573,59690,202263,0,297383527,124026780,421410307,0,279,271,279,274,202263,275,-0.284900284900285
وصنعت,2014-09-16,769610520,41,9,2,21,0,241500,125030,366530,0,507444570,262165950,769610520,0,278,273,275,275,366530,275,0
وصنعت,2014-09-17,1055518508,60,13,2,26,0,243715,260000,503715,0,510153783,545364725,1055518508,0,275,272,275,272,503715,274,-0.142857142857143
وصنعت,2014-09-20,391873657,44,13,0,19,0,187475,0,187475,0,391873657,0,391873657,0,275,272,273,272,187475,274,-0.095374344301383
وصنعت,2014-09-21,331294059,41,14,1,16,1,102921,55058,157708,271,215356928,115937131,330724959,569100,276,273,275,276,157979,274,0
وصنعت,2014-09-22,562699148,99,19,4,21,2,168165,100752,165917,103000,351715117,210984031,347215950,215483198,278,272,272,275,268917,274,-0.047732696897375
وصنعت,2014-09-23,864869925,35,14,1,15,0,399222,5000,404222,0,854284925,10585000,864869925,0,283,277,283,278,404222,277,1.19388729703916
وصنعت,2014-09-24,2021069375,53,26,1,16,0,932349,6049,938398,0,2008239446,12829929,2021069375,0,283,277,281,281,938398,282,1.65172251061822
وصنعت,2014-09-27,269939920,41,10,0,23,0,125591,0,125591,0,269939920,0,269939920,0,282,278,281,278,125591,281,-0.046425255338904
وصنعت,2014-09-28,679710648,48,24,2,22,0,239184,80549,319733,0,507577700,172132948,679710648,0,282,275,281,281,319733,280,-0.557361820715281
وصنعت,2014-09-29,273171880,17,7,0,12,0,127959,0,127959,0,273171880,0,273171880,0,281,275,275,281,127959,280,-0.046707146193368
وصنعت,2014-09-30,542532530,33,8,1,17,0,144620,110000,254620,0,307257530,235275000,542532530,0,280,277,277,278,254620,279,-0.14018691588785
وصنعت,2014-10-01,361527468,37,10,0,19,0,170803,0,170803,0,361527468,0,361527468,0,278,276,277,276,170803,279,-0.233972859148339
وصنعت,2014-10-04,144658040,29,14,0,10,0,68312,0,68312,0,144658040,0,144658040,0,281,276,281,277,68312,279,-0.046904315196998
وصنعت,2014-10-06,442727787,58,19,0,24,0,209288,0,209288,0,442727787,0,442727787,0,278,276,277,278,209288,278,-0.187705302674801
وصنعت,2014-10-07,458416150,68,22,0,22,0,215449,0,215449,0,458416150,0,458416150,0,280,276,280,276,215449,278,0
وصنعت,2014-10-08,361693332,50,18,0,16,0,171058,0,171058,0,361693332,0,361693332,0,280,275,276,276,171058,278,-0.141043723554302
وصنعت,2014-10-11,2232952608,76,10,0,55,0,1011301,0,1011301,0,2232952608,0,2232952608,0,289,289,289,289,1011301,289,3.95480225988701
وصنعت,2014-10-12,5692067291,267,95,1,94,0,2383819,121962,2505781,0,5417218348,274848943,5692067291,0,300,291,300,293,2505781,297,2.89855072463768
وصنعت,2014-10-14,1890785225,200,47,1,71,0,564868,275189,840057,0,1267416453,623368772,1890785225,0,300,291,297,300,840057,294,-0.924295774647887
وصنعت,2014-10-15,1052980196,106,44,1,31,1,257755,208344,422104,43995,580253024,472727172,954211831,98768365,301,292,301,292,466099,295,0.22212350066637
وصنعت,2014-10-18,587316998,50,20,0,22,1,260992,0,160992,100000,587316998,0,361116998,226200000,296,292,292,292,260992,295,-0.088652482269504
وصنعت,2014-10-19,2717027309,167,31,1,44,1,1009848,185673,795521,400000,2296112984,420914325,1812182200,904845109,299,294,295,299,1195521,297,0.842945874001775
وصنعت,2014-10-20,6087145316,239,67,1,83,1,2561107,20000,2098627,482480,6039885316,47260000,4948492516,1138652800,309,300,300,309,2581107,308,3.73955125384954
وصنعت,2014-10-21,2537482913,123,43,1,41,0,960026,111794,1071820,0,2273386481,264096432,2537482913,0,319,303,319,305,1071820,309,0.381679389312977
وصنعت,2014-10-22,658905693,118,29,1,29,0,240670,43134,283804,0,559636153,99269540,658905693,0,311,300,300,305,283804,307,-0.718208702999578
وصنعت,2014-10-25,4741258471,271,55,1,96,2,1876588,100000,1767880,208708,4501258471,240000000,4239294731,501963740,319,303,306,315,1976588,314,2.08510638297872
وصنعت,2014-10-26,1728289309,126,37,0,36,2,723267,0,368766,354501,1728289309,0,883123168,845166141,317,309,309,312,723267,312,-0.375156315131305
وصنعت,2014-10-27,5513384349,252,68,1,37,2,2271791,25072,1242011,1054852,5453913565,59470784,2978270674,2535113675,316,309,314,312,2296863,314,0.418410041841004
وصنعت,2014-10-28,1557270401,146,51,1,23,1,639723,20000,356880,302843,1510299646,46970755,843360671,713909730,315,306,315,307,659723,309,-1.45833333333333
وصنعت,2014-10-29,3862986648,162,56,1,35,2,1514783,100000,546796,1067987,3622986648,240000000,1304897956,2558088692,315,305,305,309,1614783,313,1.14164904862579
وصنعت,2014-11-01,8235319501,275,63,3,101,2,2232793,1097552,2743528,586817,5509175638,2726143863,6792858726,1442460775,325,312,314,325,3330345,323,3.38628762541806
وصنعت,2014-11-02,11803191452,395,150,1,114,1,4292391,300000,3492391,1100000,11031891452,771300000,8975827819,2827363633,336,333,336,336,4592391,336,3.92236150424586
وصنعت,2014-11-05,5451443356,179,35,2,67,0,1145757,900000,2045757,0,3046648117,2404795239,5451443356,0,349,340,345,349,2045757,348,3.69649805447471
وصنعت,2014-11-08,13988325718,835,150,6,137,3,4393164,684082,4713323,363923,12098520783,1889804935,12981547832,1006777886,362,352,361,358,5077246,360,3.37711069418386
وصنعت,2014-11-09,4549004287,253,72,0,65,0,1670435,0,1670435,0,4549004287,0,4549004287,0,362,350,360,353,1670435,356,-1.16152450090744
وصنعت,2014-11-10,5574414136,370,117,1,58,0,2053956,45259,2099215,0,5454296750,120117386,5574414136,0,360,344,360,346,2099215,347,-2.49724568490635
وصنعت,2014-11-11,2805075226,219,66,0,71,0,1040496,0,1040496,0,2805075226,0,2805075226,0,358,342,344,350,1040496,352,1.54425612052731
وصنعت,2014-11-12,4579123926,276,86,1,69,0,1666795,45349,1712144,0,4457588606,121535320,4579123926,0,357,347,357,352,1712144,350,-0.816023738872404
وصنعت,2014-11-15,5224860025,282,91,1,67,0,1709827,300000,2009827,0,4445265025,779595000,5224860025,0,348,336,348,337,2009827,340,-2.76738967838444
وصنعت,2014-11-16,5406617910,516,138,0,110,0,2102083,0,2102083,0,5406617910,0,5406617910,0,344,330,337,339,2102083,336,-1.07692307692308
وصنعت,2014-11-23,6913850573,329,137,0,42,4,4118007,0,2127707,1990300,6913850573,0,3563124221,3350726352,378,367,378,369,4118007,374,11.1184645929848
وصنعت,2014-11-24,33212220740,1154,323,2,91,6,18967872,57000,5875686,13149186,33112698740,99522000,10254364984,22957855756,389,385,389,389,19024872,389,3.99047051816557
وصنعت,2014-11-25,12163511962,985,273,1,172,1,6854887,46800,6148895,752792,12082068362,81443600,10827526257,1335985705,403,374,389,393,6901687,392,0.916380297823597
وصنعت,2014-11-26,10712836444,746,207,0,114,1,5902896,0,4892202,1010694,10712836444,0,8891748306,1821088138,408,391,392,408,5902896,404,3.00794551645857
وصنعت,2014-11-29,9142002869,577,195,0,84,0,5107849,0,5107849,0,9142002869,0,9142002869,0,420,388,416,388,5107849,398,-1.37741046831956
وصنعت,2014-11-30,1316454252,74,34,0,22,0,765508,0,765508,0,1316454252,0,1316454252,0,388,383,383,383,765508,383,-3.91061452513966
وصنعت,2014-12-01,5633703761,475,125,0,109,0,3368956,0,3368956,0,5633703761,0,5633703761,0,390,368,368,372,3368956,372,-2.7906976744186
وصنعت,2014-12-02,3384344093,249,101,0,53,1,2073936,0,2060550,13386,3384344093,0,3361771903,22572190,381,358,378,363,2073936,363,-2.39234449760766
وصنعت,2014-12-03,3001949413,263,66,2,72,1,1397418,460996,1841714,16700,2263121877,738827536,2974394413,27555000,374,356,358,365,1858414,359,-1.04166666666667
وصنعت,2014-12-06,2153165720,195,58,1,51,0,1320452,20000,1340452,0,2121565720,31600000,2153165720,0,368,350,363,354,1340452,357,-0.557275541795666
وصنعت,2014-12-07,1655600682,201,70,1,62,2,1020801,1000,987854,33947,1653980682,1620000,1600291202,55309480,366,350,362,365,1021801,361,0.87173100871731
وصنعت,2014-12-08,1731805300,156,59,0,47,2,1035391,0,734391,301000,1731805300,0,1226534711,505270589,375,364,371,375,1035391,372,3.27160493827161
وصنعت,2014-12-09,2536661528,228,79,0,50,1,1521299,0,1513049,8250,2536661528,0,2523171888,13489640,383,363,378,367,1521299,371,-0.358637178720861
وصنعت,2014-12-10,1211128289,99,36,0,33,1,737554,0,736554,1000,1211128289,0,1209493289,1635000,378,362,369,365,737554,366,-1.43971205758848
وصنعت,2014-12-14,1965062413,148,66,1,36,1,1218325,20000,934556,303769,1933502413,31560000,1484791168,480271245,376,351,376,351,1238325,353,-3.40839926962873
وصنعت,2014-12-15,1397200085,156,68,1,44,0,903730,10000,913730,0,1381890285,15309800,1397200085,0,351,339,341,343,913730,340,-3.65469439193447
وصنعت,2014-12-16,1286127051,149,36,1,53,1,810814,10000,697832,122982,1270477051,15650000,1093660221,192466830,353,347,347,348,820814,349,2.48528449967299
وصنعت,2014-12-17,642758760,88,35,0,26,0,415412,0,415412,0,642758760,0,642758760,0,358,341,358,343,415412,346,-0.701978302488832
وصنعت,2014-12-20,668642865,111,32,0,26,0,428229,0,428229,0,668642865,0,668642865,0,356,345,346,353,428229,347,0.19280205655527
وصنعت,2014-12-22,766853524,81,43,0,34,0,476907,0,476907,0,766853524,0,766853524,0,361,353,356,360,476907,354,1.98845413726748
وصنعت,2014-12-24,1738978742,230,39,1,47,0,777426,300000,1077426,0,1252978742,486000000,1738978742,0,365,347,365,354,1077426,359,1.50943396226415
وصنعت,2014-12-27,710346646,81,31,1,26,0,296551,150000,446551,0,472828402,237518244,710346646,0,358,349,356,353,446551,356,-0.867410161090458
وصنعت,2014-12-28,800431144,143,29,2,36,0,350845,150000,500845,0,560793188,239637956,800431144,0,358,349,349,355,500845,356,-0.0625
وصنعت,2014-12-29,888665992,102,33,1,35,0,512471,50000,562471,0,809593621,79072371,888665992,0,356,351,355,353,562471,353,-0.875547217010632
وصنعت,2014-12-30,393455246,67,24,0,18,0,248388,0,248388,0,393455246,0,393455246,0,356,351,353,352,248388,353,0
وصنعت,2014-12-31,408597475,64,21,1,28,0,208949,50000,258949,0,329947475,78650000,408597475,0,355,350,350,350,258949,352,-0.126182965299685
وصنعت,2015-01-03,545180578,79,27,1,29,0,294916,50000,344916,0,466330578,78850000,545180578,0,355,350,354,350,344916,352,-0.063171193935565
وصنعت,2015-01-04,692178089,94,25,0,34,0,433639,0,433639,0,692178089,0,692178089,0,363,352,352,353,433639,354,0.505689001264222
وصنعت,2015-01-05,236395656,160,10,0,17,0,150285,0,150285,0,236395656,0,236395656,0,360,350,350,353,150285,353,-0.188679245283019
وصنعت,2015-01-06,1330936251,99,25,0,35,0,864922,0,864922,0,1330936251,0,1330936251,0,350,339,350,345,864922,343,-3.02457466918715
وصنعت,2015-01-07,958788000,92,14,0,33,0,625486,0,625486,0,958788000,0,958788000,0,347,336,347,338,625486,341,-0.32488628979857
وصنعت,2015-01-10,1361549164,142,46,0,38,0,922296,0,922296,0,1361549164,0,1361549164,0,336,328,336,328,922296,328,-3.78096479791395
وصنعت,2015-01-11,481363948,87,33,0,33,0,334252,0,334252,0,481363948,0,481363948,0,329,315,317,327,334252,325,-1.0840108401084
وصنعت,2015-01-12,937137404,117,32,0,30,0,618299,0,618299,0,937137404,0,937137404,0,338,320,320,338,618299,335,3.15068493150685
وصنعت,2015-01-13,713548558,101,34,0,25,0,477894,0,477894,0,713548558,0,713548558,0,338,328,338,336,477894,333,-0.531208499335989
وصنعت,2015-01-14,1462299553,109,28,2,20,0,944042,52100,996142,0,1385564153,76735400,1462299553,0,338,322,323,323,996142,327,-2.00267022696929
وصنعت,2015-01-17,1099881669,47,14,0,11,0,740800,0,740800,0,1099881669,0,1099881669,0,336,324,324,333,740800,330,1.15803814713896
وصنعت,2015-01-18,620542484,58,16,0,21,0,422506,0,422506,0,620542484,0,620542484,0,336,322,324,323,422506,328,-0.606060606060606
وصنعت,2015-01-19,925688501,93,26,0,21,0,646192,0,646192,0,925688501,0,925688501,0,325,318,320,318,646192,320,-2.50677506775068
وصنعت,2015-01-20,1457876563,105,26,0,18,0,1046120,0,1046120,0,1457876563,0,1457876563,0,329,309,314,309,1046120,310,-3.12717164697707
وصنعت,2015-01-21,1688334687,160,58,0,34,0,1258813,0,1258813,0,1688334687,0,1688334687,0,310,298,301,304,1258813,298,-3.80200860832138
وصنعت,2015-01-24,590154296,58,21,0,16,1,446655,0,406655,40000,590154296,0,537686296,52468000,303,290,297,298,446655,296,-0.894854586129754
وصنعت,2015-01-25,553991291,86,30,0,13,0,414892,0,414892,0,553991291,0,553991291,0,302,296,302,296,414892,296,0.225733634311512
وصنعت,2015-01-26,728617640,60,19,1,20,0,519011,21950,540961,0,699163540,29454100,728617640,0,304,297,298,300,540961,299,0.825825825825826
وصنعت,2015-01-27,609639521,78,24,1,23,0,411797,37180,448977,0,559475021,50164500,609639521,0,309,299,300,307,448977,301,0.670141474311243
وصنعت,2015-01-28,718559880,110,28,1,40,0,462694,50000,512694,0,648875744,69684136,718559880,0,313,306,310,313,512694,308,2.51479289940828
وصنعت,2015-01-31,1153652050,72,18,0,18,0,800650,0,800650,0,1153652050,0,1153652050,0,321,314,321,321,800650,321,3.96825396825397
وصنعت,2015-02-01,721387302,96,31,1,35,1,331638,167500,440008,59130,477394748,243992554,636121842,85265460,326,314,321,324,499138,321,0.208188757807078
وصنعت,2015-02-02,224713653,49,17,1,19,0,104574,48484,153058,0,153639836,71073817,224713653,0,329,323,323,326,153058,322,0.346260387811634
وصنعت,2015-02-03,2087568480,127,45,2,18,1,1245119,190315,435434,1000000,1811759013,275809467,632471933,1455096547,329,322,323,322,1435434,324,0.345065562456867
وصنعت,2015-02-04,709525321,97,27,0,33,0,478624,0,478624,0,709525321,0,709525321,0,335,324,324,328,478624,328,1.23796423658872
وصنعت,2015-02-07,723038513,91,29,0,25,0,482291,0,482291,0,723038513,0,723038513,0,336,329,336,330,482291,331,1.15489130434783
وصنعت,2015-02-08,414405532,60,22,1,17,0,180273,100000,280273,0,265505532,148900000,414405532,0,334,326,331,326,280273,330,-0.268636668905306
وصنعت,2015-02-09,1388039629,91,16,0,28,0,959835,0,959835,0,1388039629,0,1388039629,0,327,319,327,320,959835,322,-2.62626262626263
وصنعت,2015-02-10,89558456,15,9,0,8,0,62101,0,62101,0,89558456,0,89558456,0,327,312,313,317,62101,322,0
وصنعت,2015-02-14,442183243,31,16,0,16,0,302025,0,302025,0,442183243,0,442183243,0,332,322,331,323,302025,323,0.484094052558783
وصنعت,2015-02-15,224342986,41,19,0,10,0,152478,0,152478,0,224342986,0,224342986,0,331,312,312,327,152478,324,0.275292498279422
وصنعت,2015-02-16,3457542265,155,27,0,46,1,2285622,0,805706,1479916,3457542265,0,1215469525,2242072740,337,322,322,337,2285622,337,3.84351407000686
وصنعت,2015-02-17,286486509,61,24,0,14,1,190113,0,130302,59811,286486509,0,197011954,89474555,341,332,341,332,190113,336,-0.132187706543291
وصنعت,2015-02-18,259462088,30,19,0,15,1,176309,0,173509,2800,259462088,0,255262088,4200000,334,325,330,329,176309,334,-0.595632031767042
وصنعت,2015-02-21,279559085,39,20,0,15,1,186747,0,135263,51484,279559085,0,201897401,77661684,336,329,334,334,186747,334,-0.133155792276964
وصنعت,2015-02-22,255110399,36,18,0,13,0,172735,0,172735,0,255110399,0,255110399,0,332,327,332,328,172735,332,-0.466666666666667
وصنعت,2015-02-23,562159670,44,15,0,10,0,379812,0,379812,0,562159670,0,562159670,0,332,328,329,328,379812,331,-0.267916945746818
وصنعت,2015-02-24,549129033,64,18,0,20,1,366184,0,156004,210180,549129033,0,233854033,315275000,334,332,334,334,366184,332,0.201477501678979
وصنعت,2015-02-25,209289719,28,20,0,8,2,142250,0,71250,71000,209289719,0,104578219,104711500,334,324,334,324,142250,332,-0.134048257372654
وصنعت,2015-02-28,159017129,28,14,0,7,0,108765,0,108765,0,159017129,0,159017129,0,328,323,326,328,108765,331,-0.201342281879195
وصنعت,2015-03-01,654596776,66,33,0,16,0,449396,0,449396,0,654596776,0,654596776,0,332,323,323,330,449396,328,-0.739744451916611
وصنعت,2015-03-02,479399768,63,22,0,22,0,322977,0,322977,0,479399768,0,479399768,0,334,326,334,331,322977,329,0.13550135501355
وصنعت,2015-03-03,604237985,64,22,5,20,1,399190,4500,238909,164781,597510485,6727500,357066485,247171500,334,327,334,333,403690,330,0.40595399188092
وصنعت,2015-03-04,461736384,42,16,1,19,1,298323,10000,150124,158199,446806384,14930000,224437884,237298500,334,330,334,334,308323,331,0.202156334231806
وصنعت,2015-03-07,2453486832,171,35,2,37,1,647063,1004200,1485962,165301,961710474,1491776358,2205535332,247951500,334,325,332,334,1651263,331,-0.067249495628783
وصنعت,2015-03-08,487096994,65,35,2,17,0,327844,5810,333654,0,478701094,8395900,487096994,0,332,321,327,322,333654,329,-0.471063257065949
وصنعت,2015-03-09,458736288,58,19,1,13,0,311880,700,312580,0,457703088,1033200,458736288,0,328,324,324,328,312580,328,-0.202839756592292
وصنعت,2015-03-10,729413764,103,48,0,39,0,503805,0,503805,0,729413764,0,729413764,0,330,316,328,329,503805,326,-0.813008130081301
وصنعت,2015-03-16,1513261214,160,56,0,23,1,1218450,0,1217750,700,1513261214,0,1512393214,868000,343,329,343,329,1218450,331,1.47058823529412
وصنعت,2015-03-17,1146727440,146,62,0,22,0,959615,0,959615,0,1146727440,0,1146727440,0,330,318,320,318,959615,320,-3.05958132045089
وصنعت,2015-03-18,1297816532,151,32,0,49,0,1045112,0,1045112,0,1297816532,0,1297816532,0,333,320,327,330,1045112,329,2.74086378737542
وصنعت,2015-03-25,208339093,31,11,0,19,0,167648,0,167648,0,208339093,0,208339093,0,338,320,320,327,167648,330,0.080840743734842
وصنعت,2015-03-28,801588569,119,28,0,36,0,627917,0,627917,0,801588569,0,801588569,0,343,328,328,342,627917,335,1.61550888529887
وصنعت,2015-03-29,1711263000,139,43,0,35,0,1308730,0,1308730,0,1711263000,0,1711263000,0,348,341,341,348,1308730,348,3.97456279809221
وصنعت,2015-03-30,937030839,72,28,0,26,0,722276,0,722276,0,937030839,0,937030839,0,358,337,354,339,722276,347,-0.458715596330275
وصنعت,2015-03-31,377189917,49,27,0,17,0,293222,0,293222,0,377189917,0,377189917,0,351,333,333,336,293222,346,-0.307219662058372
وصنعت,2015-04-04,68846215,3,1,0,3,0,51035,0,51035,0,68846215,0,68846215,0,359,359,359,359,51035,346,0.154083204930663
وصنعت,2015-04-05,2757383720,49,12,2,7,1,1539485,500000,59708,1979777,2081383720,676000000,80725216,2676658504,360,360,360,360,2039485,360,4
وصنعت,2015-04-06,2514670951,231,93,0,54,0,1881985,0,1881985,0,2514670951,0,2514670951,0,370,346,370,350,1881985,356,-1.18343195266272
وصنعت,2015-04-07,782256947,131,52,0,24,0,603746,0,603746,0,782256947,0,782256947,0,354,342,347,342,603746,350,-1.49700598802395
وصنعت,2015-04-08,3185138099,189,61,1,42,0,2410729,40000,2450729,0,3132378099,52760000,3185138099,0,351,336,337,344,2450729,346,-1.21580547112462
وصنعت,2015-04-11,1553274162,150,82,0,14,0,1237466,0,1237466,0,1553274162,0,1553274162,0,346,332,344,332,1237466,334,-3.46153846153846
وصنعت,2015-04-12,1862623730,176,66,0,29,0,1536874,0,1536874,0,1862623730,0,1862623730,0,331,321,325,321,1536874,323,-3.42629482071713
وصنعت,2015-04-13,1104090066,127,35,0,21,0,922609,0,922609,0,1104090066,0,1104090066,0,323,315,323,319,922609,319,-0.99009900990099
وصنعت,2015-04-14,788777877,100,43,0,20,0,656492,0,656492,0,788777877,0,788777877,0,328,317,328,321,656492,320,0.083333333333333
وصنعت,2015-04-15,1126883604,105,38,0,29,0,942350,0,942350,0,1126883604,0,1126883604,0,325,314,318,319,942350,319,-0.333055786844296
وصنعت,2015-04-18,613080789,94,42,0,24,1,516084,0,248584,267500,613080789,0,297633349,315447440,330,313,330,317,516084,318,-0.334168755221387
وصنعت,2015-04-19,236161875,48,23,0,18,0,197297,0,197297,0,236161875,0,236161875,0,327,317,327,317,197297,318,0.083822296730931
وصنعت,2015-04-20,368030234,52,17,0,20,0,308651,0,308651,0,368030234,0,368030234,0,319,314,315,315,308651,318,0
وصنعت,2015-04-21,497573866,59,29,0,18,1,417188,0,351788,65400,497573866,0,419476162,78097704,319,314,314,318,417188,318,0
وصنعت,2015-04-22,763743793,74,28,0,28,0,638301,0,638301,0,763743793,0,763743793,0,323,314,319,319,638301,318,0.083752093802345
وصنعت,2015-04-25,1708131237,152,21,0,76,1,1379510,0,1153907,225603,1708131237,0,1428571275,279559962,331,322,322,330,1379510,330,3.59832635983264
وصنعت,2015-04-26,1141990102,74,19,0,35,0,905123,0,905123,0,1141990102,0,1141990102,0,338,330,333,330,905123,334,1.45395799676898
وصنعت,2015-04-27,232025290,39,18,1,17,0,160549,30000,190549,0,195653415,36371875,232025290,0,330,321,323,321,190549,333,-0.477707006369427
وصنعت,2015-04-28,512807721,122,24,1,44,0,383401,41000,424401,0,463282721,49525000,512807721,0,327,320,327,321,424401,329,-1.2
وصنعت,2015-04-29,444353444,55,30,1,17,0,369963,10,369973,0,444341394,12050,444353444,0,328,317,319,320,369973,326,-0.809716599190283
وصنعت,2015-05-03,404331773,44,18,1,18,1,310020,30000,293210,46810,368691773,35640000,348748303,55583470,322,315,317,322,340020,323,-0.816326530612245
وصنعت,2015-05-04,814264883,60,19,0,18,0,690083,0,690083,0,814264883,0,814264883,0,322,313,317,315,690083,318,-1.64609053497942
وصنعت,2015-05-05,824988113,104,25,1,19,0,658137,50000,708137,0,766688113,58300000,824988113,0,318,306,318,307,708137,313,-1.50627615062762
وصنعت,2015-05-06,96453571,28,12,0,14,0,82247,0,82247,0,96453571,0,96453571,0,318,306,306,310,82247,313,0
وصنعت,2015-05-09,797324357,87,29,1,19,1,639023,60352,699365,10,729066245,68258112,797312917,11440,307,301,305,301,699375,307,-1.86915887850467
وصنعت,2015-05-10,737135519,81,48,1,17,0,562767,100000,662767,0,626235519,110900000,737135519,0,303,295,303,295,662767,301,-2.07792207792208
وصنعت,2015-05-11,265645410,39,14,0,14,0,233732,0,233732,0,265645410,0,265645410,0,305,299,305,299,233732,301,0.08841732979664
وصنعت,2015-05-12,899164801,50,28,1,6,0,756131,50000,806131,0,843564801,55600000,899164801,0,309,296,309,301,806131,298,-0.971731448763251
وصنعت,2015-05-13,1777237605,151,74,2,16,0,1549551,91003,1640554,0,1678455178,98782427,1777237605,0,299,287,298,291,1640554,288,-3.38983050847458
وصنعت,2015-05-17,1941183190,205,85,0,12,0,1862754,0,1862754,0,1941183190,0,1941183190,0,287,277,282,277,1862754,277,-3.78578024007387
وصنعت,2015-05-18,5960232416,560,140,1,27,0,5830702,80000,5910702,0,5880152416,80080000,5960232416,0,280,266,278,277,5910702,268,-3.26295585412668
وصنعت,2015-05-19,2044782208,151,52,0,40,0,1976848,0,1976848,0,2044782208,0,2044782208,0,279,272,272,279,1976848,275,2.57936507936508
وصنعت,2015-05-20,1194229106,114,44,1,23,0,1113576,20000,1133576,0,1173249106,20980000,1194229106,0,282,278,278,279,1133576,280,1.74081237911025
وصنعت,2015-05-23,357847331,59,18,0,17,0,346358,0,346358,0,357847331,0,357847331,0,279,273,277,275,346358,279,-0.475285171102662
وصنعت,2015-05-24,1045096857,141,39,1,19,0,919766,100000,1019766,0,942076857,103020000,1045096857,0,276,269,276,275,1019766,274,-1.81470869149952
وصنعت,2015-05-25,596834023,66,33,1,17,0,574142,2000,576142,0,594737523,2096500,596834023,0,281,275,281,276,576142,275,0.389105058365759
وصنعت,2015-05-26,530804315,73,24,0,18,0,515043,0,515043,0,530804315,0,530804315,0,277,272,277,274,515043,274,-0.096899224806202
وصنعت,2015-05-27,186930151,70,17,1,20,0,129223,52500,181723,0,132882754,54047397,186930151,0,279,272,276,275,181723,274,0
وصنعت,2015-05-30,202709994,29,14,1,16,0,193580,3153,196733,0,199430874,3279120,202709994,0,277,272,277,274,196733,274,0
وصنعت,2015-05-31,5402294294,87,19,0,15,0,5236377,0,5236377,0,5402294294,0,5402294294,0,276,272,272,273,5236377,275,0.096993210475267
وصنعت,2015-06-01,254723987,57,18,0,16,0,247814,0,247814,0,254723987,0,254723987,0,276,272,276,273,247814,274,-0.096899224806202
وصنعت,2015-06-02,201350413,53,17,0,21,0,195299,0,195299,0,201350413,0,201350413,0,276,272,276,276,195299,274,0
وصنعت,2015-06-06,380641922,62,25,0,15,0,371214,0,371214,0,380641922,0,380641922,0,279,272,273,272,371214,274,-0.193986420950533
وصنعت,2015-06-07,163606105,41,18,0,13,0,159476,0,159476,0,163606105,0,163606105,0,276,270,274,270,159476,274,0
وصنعت,2015-06-08,306382905,46,22,0,13,0,301687,0,301687,0,306382905,0,306382905,0,274,269,272,269,301687,273,-0.291545189504373
وصنعت,2015-06-09,211152151,39,18,0,13,0,210586,0,210586,0,211152151,0,211152151,0,269,266,269,267,210586,272,-0.389863547758285
وصنعت,2015-06-10,151623493,38,22,0,12,0,151226,0,151226,0,151623493,0,151623493,0,268,261,267,268,151226,272,-0.195694716242661
وصنعت,2015-06-13,182280627,37,17,0,17,0,180858,0,180858,0,182280627,0,182280627,0,272,266,272,271,180858,271,-0.196078431372549
وصنعت,2015-06-14,342464484,41,18,0,11,0,340061,0,340061,0,342464484,0,342464484,0,272,266,267,266,340061,270,-0.294695481335953
وصنعت,2015-06-15,629578898,46,27,1,9,0,531383,100000,631383,0,529778898,99800000,629578898,0,273,265,273,266,631383,268,-0.886699507389162
وصنعت,2015-06-16,361075127,29,8,0,17,0,356267,0,356267,0,361075127,0,361075127,0,273,268,269,268,356267,268,0.198807157057654
وصنعت,2015-06-17,562187748,82,27,1,36,0,460695,79994,540689,0,478434030,83753718,562187748,0,279,272,274,279,540689,272,1.38888888888889
وصنعت,2015-06-20,440891010,42,21,0,22,0,427103,0,427103,0,440891010,0,440891010,0,278,273,278,274,427103,273,0.391389432485323
وصنعت,2015-06-21,236164607,36,14,1,20,0,226792,1000,227792,0,235143996,1020611,236164607,0,278,266,272,276,227792,274,0.194931773879142
وصنعت,2015-06-22,787668139,68,16,0,31,1,750969,0,550969,200000,787668139,0,579423721,208244418,285,276,276,282,750969,277,1.26459143968872
وصنعت,2015-06-23,794067621,87,28,0,35,0,737502,0,737502,0,794067621,0,794067621,0,290,282,282,289,737502,283,2.1133525456292
وصنعت,2015-06-24,382156632,36,18,0,13,0,361669,0,361669,0,382156632,0,382156632,0,289,277,280,282,361669,282,-0.188146754468485
وصنعت,2015-06-27,160798659,25,11,0,12,0,152419,0,152419,0,160798659,0,160798659,0,285,277,282,280,152419,282,-0.094250706880302
وصنعت,2015-06-28,668411435,91,17,0,17,0,640650,0,640650,0,668411435,0,668411435,0,279,277,277,277,640650,280,-0.849056603773585
وصنعت,2015-06-29,134867690,26,8,0,14,0,127221,0,127221,0,134867690,0,134867690,0,290,280,290,282,127221,280,0.095147478591817
وصنعت,2015-06-30,1028228186,133,24,0,57,0,939101,0,939101,0,1028228186,0,1028228186,0,294,282,282,294,939101,289,3.2319391634981
وصنعت,2015-07-01,213254751,49,19,1,21,0,174038,20006,194044,0,191408199,21846552,213254751,0,298,288,295,293,194044,290,0.184162062615101
وصنعت,2015-07-04,390422272,31,6,0,24,0,342266,0,342266,0,390422272,0,390422272,0,304,293,293,304,342266,294,1.37867647058824
وصنعت,2015-07-05,1575817290,88,22,2,47,0,961755,400000,1361755,0,1112632290,463185000,1575817290,0,308,303,308,308,1361755,308,4.89573889392566
وصنعت,2015-07-06,2832274152,205,40,0,68,1,2352840,0,2252840,100000,2832274152,0,2710874152,121400000,323,309,309,323,2352840,320,4.06222990492653
وصنعت,2015-07-07,2592063178,212,62,0,77,1,2055434,0,1955434,100000,2592063178,0,2465663178,126400000,336,322,335,336,2055434,336,4.73421926910299
وصنعت,2015-07-11,638671480,98,38,0,30,0,517524,0,517524,0,638671480,0,638671480,0,338,320,325,332,517524,332,-0.951625693893735
وصنعت,2015-07-12,635987998,71,28,0,33,0,504072,0,504072,0,635987998,0,635987998,0,343,330,338,333,504072,334,0.400320256204964
وصنعت,2015-07-13,2271327528,137,36,0,50,2,1730585,0,1071367,659218,2271327528,0,1403796640,867530888,350,341,343,350,1730585,349,4.62519936204147
وصنعت,2015-07-14,975019103,86,35,0,45,0,744369,0,744369,0,975019103,0,975019103,0,362,338,353,357,744369,349,-0.076219512195122
وصنعت,2015-07-15,1189087823,102,34,0,39,0,946743,0,946743,0,1189087823,0,1189087823,0,362,332,362,334,946743,338,-3.27993897787948
وصنعت,2015-07-20,380314032,38,14,1,16,0,308818,3000,311818,0,376645832,3668200,380314032,0,329,321,321,323,311818,334,-1.02523659305994
وصنعت,2015-07-21,274390456,30,15,0,20,0,223680,0,223680,0,274390456,0,274390456,0,335,323,323,325,223680,333,-0.398406374501992
وصنعت,2015-07-22,622649181,56,31,0,10,0,518784,0,518784,0,622649181,0,622649181,0,323,316,322,316,518784,327,-1.76
وصنعت,2015-07-25,123152674,21,15,0,4,0,105332,0,105332,0,123152674,0,123152674,0,317,311,311,311,105332,326,-0.407166123778502
وصنعت,2015-07-26,1063261259,72,31,0,24,0,914204,0,914204,0,1063261259,0,1063261259,0,317,309,309,310,914204,313,-3.76124284546198
وصنعت,2015-07-27,695500303,58,15,0,24,0,613976,0,613976,0,695500303,0,695500303,0,309,298,304,300,613976,307,-1.95412064570943
وصنعت,2015-07-28,317414632,53,19,0,18,0,276697,0,276697,0,317414632,0,317414632,0,308,294,294,307,276697,307,-0.173310225303293
وصنعت,2015-07-29,319497204,60,20,0,25,0,272838,0,272838,0,319497204,0,319497204,0,315,308,314,313,272838,308,0.347222222222222
وصنعت,2015-08-01,273029035,63,13,0,19,0,231959,0,231959,0,273029035,0,273029035,0,318,311,313,311,231959,309,0.346020761245675
وصنعت,2015-08-02,215463722,33,13,0,16,0,185043,0,185043,0,215463722,0,215463722,0,312,308,312,308,185043,309,0.086206896551724
وصنعت,2015-08-03,546236255,65,33,1,13,0,469603,10000,479603,0,534896255,11340000,546236255,0,315,297,315,303,479603,307,-0.775193798449612
وصنعت,2015-08-04,321667173,61,16,0,27,1,276241,0,271741,4500,321667173,0,316357173,5310000,314,300,300,311,276241,307,0.260416666666667
وصنعت,2015-08-05,479434640,32,9,0,12,0,416263,0,416263,0,479434640,0,479434640,0,314,306,311,306,416263,307,-0.086580086580087
وصنعت,2015-08-08,778392901,64,26,1,23,0,673240,10500,683740,0,766307401,12085500,778392901,0,306,293,306,293,683740,305,-0.779896013864818
وصنعت,2015-08-09,330721853,61,37,1,13,1,276205,24000,226810,73395,304251853,26470000,250357313,80364540,297,290,297,291,300205,302,-0.960698689956332
وصنعت,2015-08-10,307761236,42,22,1,10,0,279534,2000,281534,0,305579236,2182000,307761236,0,298,287,293,289,281534,299,-0.881834215167548
وصنعت,2015-08-12,426383070,51,12,0,12,0,390697,0,390697,0,426383070,0,426383070,0,294,289,289,290,390697,296,-0.97864768683274
وصنعت,2015-08-15,87661800,18,10,0,9,0,81160,0,81160,0,87661800,0,87661800,0,288,287,288,287,81160,296,-0.179694519317161
وصنعت,2015-08-16,159765166,44,21,1,11,0,143474,5000,148474,0,154410166,5355000,159765166,0,295,285,285,285,148474,295,-0.36003600360036
وصنعت,2015-08-17,92676554,10,7,0,5,0,85796,0,85796,0,92676554,0,92676554,0,292,286,287,286,85796,294,-0.1806684733514
وصنعت,2015-08-18,87993435,29,15,0,8,0,82412,0,82412,0,87993435,0,87993435,0,285,283,285,283,82412,293,-0.271493212669683
وصنعت,2015-08-19,221677764,49,30,0,9,1,208917,0,117565,91352,221677764,0,124737395,96940369,285,281,282,282,208917,291,-0.635208711433757
وصنعت,2015-08-22,438154960,49,23,0,15,0,415247,0,415247,0,438154960,0,438154960,0,283,279,281,280,415247,288,-1.27853881278539
وصنعت,2015-08-23,474680263,63,27,0,18,0,448631,0,448631,0,474680263,0,474680263,0,287,278,285,280,448631,285,-0.832562442183164
وصنعت,2015-08-24,356912223,51,13,0,18,0,339091,0,339091,0,356912223,0,356912223,0,282,279,280,280,339091,284,-0.466417910447761
وصنعت,2015-08-25,404926733,48,19,0,15,0,389383,0,389383,0,404926733,0,404926733,0,282,274,279,274,389383,282,-0.84348641049672
وصنعت,2015-08-26,366271110,45,19,0,16,0,355810,0,355810,0,366271110,0,366271110,0,279,273,279,273,355810,279,-0.756143667296786
وصنعت,2015-08-29,208478646,35,11,0,17,0,197119,0,197119,0,208478646,0,208478646,0,282,279,279,282,197119,280,0.095238095238095
وصنعت,2015-08-30,373468642,44,20,0,8,1,354455,0,118029,236426,373468642,0,124397774,249070868,285,278,280,279,354455,280,0.095147478591817
وصنعت,2015-08-31,133046051,26,13,0,8,1,127602,0,64028,63574,133046051,0,66662434,66383617,279,276,277,277,127602,280,-0.095057034220532
وصنعت,2015-09-01,267941543,39,12,0,22,0,254022,0,254022,0,267941543,0,267941543,0,283,274,275,279,254022,280,0.095147478591817
وصنعت,2015-09-02,70559000,11,3,0,8,0,66600,0,66600,0,70559000,0,70559000,0,282,282,282,282,66600,280,0
وصنعت,2015-09-05,757485684,90,27,0,35,0,702259,0,702259,0,757485684,0,757485684,0,290,282,282,285,702259,284,1.52091254752852
وصنعت,2015-09-06,365273758,30,16,0,7,0,344817,0,344817,0,365273758,0,365273758,0,284,281,282,281,344817,284,-0.187265917602996
وصنعت,2015-09-07,377370497,29,16,0,8,0,357185,0,357185,0,377370497,0,377370497,0,283,278,281,283,357185,283,-0.281425891181989
وصنعت,2015-09-08,80991127,15,7,0,3,0,76955,0,76955,0,80991127,0,80991127,0,285,279,285,279,76955,283,-0.094073377234243
وصنعت,2015-09-09,108054960,26,12,0,10,0,102709,0,102709,0,108054960,0,108054960,0,286,280,280,286,102709,282,-0.094161958568738
وصنعت,2015-09-12,172303840,21,10,0,14,0,161622,0,161622,0,172303840,0,172303840,0,287,282,287,282,161622,283,0.094250706880302
وصنعت,2015-09-13,185332184,15,9,0,7,0,178400,0,178400,0,185332184,0,185332184,0,281,272,281,275,178400,282,-0.282485875706215
وصنعت,2015-09-14,349632191,46,24,0,6,0,340299,0,340299,0,349632191,0,349632191,0,275,272,273,272,340299,279,-0.84985835694051
وصنعت,2015-09-15,386031959,60,31,0,9,1,380888,0,353773,27115,386031959,0,358374659,27657300,272,268,271,269,380888,276,-1.14285714285714
وصنعت,2015-09-16,117364031,19,6,1,9,0,105368,10000,115368,0,107184031,10180000,117364031,0,272,271,271,272,115368,276,-0.192678227360308
وصنعت,2015-09-19,292972806,44,11,1,14,0,279934,5000,284934,0,287839346,5133460,292972806,0,277,272,272,272,284934,275,-0.193050193050193
وصنعت,2015-09-20,501965426,59,20,0,13,1,498508,0,228508,270000,501965426,0,231875926,270089500,272,266,272,266,498508,272,-1.06382978723404
وصنعت,2015-09-21,132721003,14,6,0,6,1,131486,0,128601,2885,132721003,0,129835003,2886000,270,266,266,270,131486,272,-0.097751710654937
وصنعت,2015-09-22,62899500,6,5,1,2,0,55000,6500,61500,0,56250000,6649500,62899500,0,277,272,277,272,61500,272,0
وصنعت,2015-09-23,324380602,47,25,1,11,0,306026,13500,319526,0,310705102,13675500,324380602,0,274,269,272,269,319526,272,-0.195694716242661
وصنعت,2015-09-26,147193216,21,14,1,7,0,136805,10000,146805,0,137143216,10050000,147193216,0,269,266,267,266,146805,271,-0.196078431372549
وصنعت,2015-09-27,157619760,28,14,0,10,0,156577,0,156577,0,157619760,0,157619760,0,270,266,266,269,156577,271,-0.098231827111984
وصنعت,2015-09-28,147864208,25,14,1,11,1,137336,10000,147259,77,137844516,10019692,147787362,76846,269,264,264,269,147336,270,-0.196656833824975
وصنعت,2015-09-29,159133660,25,12,0,9,0,158228,0,158228,0,159133660,0,159133660,0,270,266,266,270,158228,270,-0.098522167487685
وصنعت,2015-09-30,179360784,19,5,0,13,0,176996,0,176996,0,179360784,0,179360784,0,274,268,268,273,176996,270,0
وصنعت,2015-10-03,133791838,24,11,1,9,0,119490,13910,133400,0,119881838,13910000,133791838,0,272,266,272,267,133400,270,-0.09861932938856
وصنعت,2015-10-04,216819538,27,6,1,15,1,13899,200000,212399,1500,13919151,202900387,215324387,1495151,272,265,266,272,213899,270,0
وصنعت,2015-10-05,1771963219,251,81,5,35,1,1337283,457090,1793373,1000,1317230918,454732301,1770959219,1004000,269,258,266,266,1794373,263,-2.46791707798618
وصنعت,2015-10-06,1675604114,257,76,0,27,1,1762909,0,1761409,1500,1675604114,0,1674179114,1425000,259,250,258,259,1762909,253,-3.84615384615385
وصنعت,2015-10-07,218665820,44,22,1,23,0,217616,10000,227616,0,209065775,9600045,218665820,0,257,253,256,257,227616,253,0.210526315789474
وصنعت,2015-10-10,549555476,128,37,1,21,0,575928,10000,585928,0,540185476,9370000,549555476,0,260,247,260,250,585928,252,-0.735294117647059
وصنعت,2015-10-11,492511889,75,22,3,32,0,344036,178394,522430,0,324379099,168132790,492511889,0,253,247,247,253,522430,251,-0.105820105820106
وصنعت,2015-10-12,296577491,63,16,1,25,0,200373,108924,309297,0,192222771,104354720,296577491,0,258,252,254,254,309297,252,0.423728813559322
وصنعت,2015-10-13,293841392,48,24,1,18,0,295914,10000,305914,0,284391392,9450000,293841392,0,258,249,252,258,305914,253,0.316455696202532
وصنعت,2015-10-14,1415522853,111,39,0,38,0,1434530,0,1434530,0,1415522853,0,1415522853,0,266,257,257,263,1434530,263,3.78548895899054
وصنعت,2015-10-17,1158776212,156,49,2,54,1,828007,307231,991113,144125,844729126,314047086,1009462712,149313500,276,265,269,276,1135238,271,3.24214792299899
وصنعت,2015-10-18,692859216,106,47,0,32,0,692419,0,692419,0,692859216,0,692859216,0,279,264,278,266,692419,268,-1.07948969578018
وصنعت,2015-10-19,391223471,68,50,0,10,0,401643,0,401643,0,391223471,0,391223471,0,272,256,266,258,401643,265,-1.09126984126984
وصنعت,2015-10-20,280845015,38,30,0,7,0,290519,0,290519,0,280845015,0,280845015,0,261,255,258,261,290519,264,-0.702106318956871
وصنعت,2015-10-21,425720281,50,32,0,15,0,442799,0,442799,0,425720281,0,425720281,0,261,252,255,256,442799,261,-1.11111111111111
وصنعت,2015-10-25,389085420,65,25,1,24,0,376859,32500,409359,0,358242920,30842500,389085420,0,256,252,253,252,409359,258,-1.02145045965271
وصنعت,2015-10-26,864749148,74,14,2,39,1,82516,801891,872407,12000,79432300,785316848,852905148,11844000,263,250,250,261,884407,260,0.619195046439629
وصنعت,2015-10-27,943229635,53,15,1,16,1,116058,847292,663350,300000,113464635,829765000,649229635,294000000,264,256,264,262,963350,260,0.307692307692308
وصنعت,2015-10-28,362023058,37,7,1,17,0,48200,322017,370217,0,46583118,315439940,362023058,0,263,257,262,257,370217,260,0
وصنعت,2015-10-31,522813751,50,9,1,27,0,263829,265991,529820,0,261788571,261025180,522813751,0,266,260,260,262,529820,261,0.408997955010225
وصنعت,2015-11-01,1248901769,112,11,1,35,0,147265,1101545,1248810,0,147252343,1101649426,1248901769,0,268,262,266,268,1248810,266,1.83299389002037
وصنعت,2015-11-02,2632827008,156,31,3,47,2,1660822,938712,1974534,625000,1679446756,953380252,1999065966,633761042,277,264,266,269,2599534,270,1.3
وصنعت,2015-11-03,958176263,163,25,2,15,0,414268,542357,956625,0,415339263,542837000,958176263,0,274,265,274,269,956625,267,-0.888450148075025
وصنعت,2015-11-04,544639976,51,16,1,17,0,448787,90350,539137,0,453170996,91468980,544639976,0,274,266,274,266,539137,268,0.298804780876494
وصنعت,2015-11-07,603455343,76,10,1,21,0,74347,526600,600947,0,75437567,528017776,603455343,0,272,265,267,269,600947,268,-0.099304865938431
وصنعت,2015-11-08,460710445,63,13,1,24,0,309966,148627,458593,0,311293755,149416690,460710445,0,270,266,270,269,458593,268,-0.099403578528827
وصنعت,2015-11-09,320377764,154,12,2,16,0,170800,149189,319989,0,171041340,149336424,320377764,0,270,266,270,268,319989,267,-0.099502487562189
وصنعت,2015-11-10,294421614,55,11,2,23,0,102660,190982,293642,0,102787760,191633854,294421614,0,268,265,268,267,293642,267,0
وصنعت,2015-11-11,287218242,49,12,1,16,0,250618,36885,287503,0,250363950,36854292,287218242,0,270,265,266,266,287503,267,-0.099601593625498
وصنعت,2015-11-14,318246106,56,15,3,18,0,147160,171410,318570,0,147070676,171175430,318246106,0,267,265,265,266,318570,267,-0.099700897308076
وصنعت,2015-11-15,661872104,107,9,2,16,0,98054,566250,664304,0,97010116,564861988,661872104,0,266,261,265,266,664304,266,-0.29940119760479
وصنعت,2015-11-16,902023050,77,16,4,29,0,349259,550933,900192,0,349154490,552868560,902023050,0,269,264,266,266,900192,266,0.2002002002002
وصنعت,2015-11-17,454781224,48,17,3,12,0,342875,112500,455375,0,342356224,112425000,454781224,0,271,261,270,266,455375,266,-0.0999000999001
وصنعت,2015-11-18,867461520,51,12,2,14,0,656909,210620,867529,0,656921400,210540120,867461520,0,269,263,266,266,867529,266,0
وصنعت,2015-11-21,457123600,35,10,1,5,1,89374,368176,443550,14000,89325626,367797974,443123600,14000000,266,264,266,266,457550,266,0
وصنعت,2015-11-22,813073102,45,8,1,7,2,108208,706559,736605,78162,107945206,705127896,734960464,78112638,266,264,264,266,814767,266,-0.1
وصنعت,2015-11-23,490150644,36,8,1,10,1,148092,342500,438897,51695,148005237,342145407,438512424,51638220,266,265,266,265,490592,266,0
وصنعت,2015-11-24,877584360,117,9,1,20,1,161416,718949,751427,128938,160486190,717098170,748775298,128809062,266,264,266,266,880365,265,-0.2002002002002
وصنعت,2015-11-25,425723016,67,5,2,19,0,24711,402000,426711,0,24297548,401425468,425723016,0,266,258,266,266,426711,265,0
وصنعت,2015-11-28,659160315,44,9,1,17,0,159985,500433,660418,0,159390384,499769931,659160315,0,266,262,262,263,660418,266,0.100300902708124
وصنعت,2015-11-29,299413876,46,1,1,18,0,1000,298771,299771,0,999010,298414866,299413876,0,268,264,266,266,299771,266,0
وصنعت,2015-11-30,179772800,52,12,2,22,0,40031,140146,180177,0,39752486,140020314,179772800,0,268,257,266,268,180177,266,0
وصنعت,2015-12-01,985168900,78,20,2,17,0,525473,467418,992891,0,520418604,464750296,985168900,0,268,258,266,266,992891,264,-0.501002004008016
وصنعت,2015-12-05,41873674,20,3,2,6,0,12032,30097,42129,0,11922254,29951420,41873674,0,266,261,266,266,42129,264,0
وصنعت,2015-12-06,393930230,17,9,1,4,0,369641,30000,399641,0,364350230,29580000,393930230,0,265,262,262,262,399641,264,-0.201409869083585
وصنعت,2015-12-07,817522291,160,8,1,23,0,157350,665097,822447,0,154355971,663166320,817522291,0,266,261,266,266,822447,264,0.201816347124117
وصنعت,2015-12-08,376290099,50,5,1,21,0,203310,174860,378170,0,202630530,173659569,376290099,0,266,258,261,266,378170,265,0.100704934541793
وصنعت,2015-12-09,511817543,76,9,1,16,1,108258,406838,274100,240996,107850785,403966758,272512334,239305209,266,261,266,266,515096,265,0
وصنعت,2015-12-13,316714330,111,3,1,8,1,8000,311100,182790,136310,7933250,308781080,181223334,135490996,266,264,265,265,319100,265,0
وصنعت,2015-12-14,319611799,145,6,2,20,1,38503,282245,257058,63690,38406875,281204924,256358129,63253670,266,263,265,266,320748,265,0.100603621730382
وصنعت,2015-12-15,362430030,44,13,0,5,0,370365,0,370365,0,362430030,0,362430030,0,266,259,266,259,370365,264,-0.50251256281407
وصنعت,2015-12-16,101871188,24,16,1,7,0,86704,17700,104404,0,84651188,17220000,101871188,0,265,256,261,263,104404,263,-0.101010101010101
وصنعت,2015-12-19,1357657229,209,28,1,16,2,598307,821667,820974,599000,570028204,787629025,789068239,568588990,265,250,261,255,1419974,254,-3.33670374115268
وصنعت,2015-12-20,1479064859,152,12,1,58,0,51386,1467855,1519241,0,48458114,1430606745,1479064859,0,266,248,252,266,1519241,259,1.88284518828452
وصنعت,2015-12-21,1773844527,165,15,3,51,1,764347,996097,1132564,627880,765745914,1008098613,1142169958,631674569,272,265,266,269,1760444,268,3.49075975359343
وصنعت,2015-12-22,90040009,20,3,1,17,0,66652,23000,89652,0,66968009,23072000,90040009,0,269,261,261,269,89652,268,0
وصنعت,2015-12-23,286538539,58,23,1,18,0,281937,9268,291205,0,277324159,9214380,286538539,0,271,257,271,266,291205,267,-0.595238095238095
وصنعت,2015-12-26,37244000,11,5,1,5,0,16500,21000,37500,0,16198000,21046000,37244000,0,269,261,266,261,37500,267,0
وصنعت,2015-12-27,133889025,18,10,0,12,0,134644,0,134644,0,133889025,0,133889025,0,267,260,260,265,134644,266,-0.099800399201597
وصنعت,2015-12-28,156437073,21,7,1,15,0,92932,64475,157407,0,92496873,63940200,156437073,0,266,260,261,265,157407,266,-0.0999000999001
وصنعت,2015-12-30,525790773,85,17,3,41,0,187243,335080,522323,0,188415336,337375437,525790773,0,273,265,266,268,522323,267,0.3
وصنعت,2016-01-02,414606998,36,6,2,18,0,201505,210000,411505,0,203986998,210620000,414606998,0,272,267,272,267,411505,268,0.199401794616152
وصنعت,2016-01-03,104019492,21,11,0,10,1,103974,0,103094,880,104019492,0,103144772,874720,270,261,261,266,103974,268,0
وصنعت,2016-01-04,616036850,84,25,0,22,0,616992,0,616992,0,616036850,0,616036850,0,269,264,266,265,616992,267,-0.298507462686567
وصنعت,2016-01-05,477976047,64,18,0,31,0,468971,0,468971,0,477976047,0,477976047,0,274,269,270,272,468971,269,0.698602794411178
وصنعت,2016-01-06,1101189900,130,14,0,66,1,1055069,0,955069,100000,1101189900,0,995289900,105900000,282,272,276,282,1055069,277,3.07234886025768
وصنعت,2016-01-09,3376481858,196,33,0,69,2,3108731,0,2053731,1055000,3376481858,0,2224421858,1152060000,291,279,281,283,3108731,289,4.42307692307692
وصنعت,2016-01-10,184224058,42,23,0,17,0,175130,0,175130,0,184224058,0,184224058,0,285,277,277,282,175130,288,-0.460405156537753
وصنعت,2016-01-11,532008853,78,23,0,34,0,493557,0,493557,0,532008853,0,532008853,0,289,279,279,284,493557,287,-0.092506938020352
وصنعت,2016-01-12,1345620167,156,57,0,29,1,1288334,0,953228,335106,1345620167,0,997076141,348544026,283,276,283,276,1288334,278,-3.33333333333333
وصنعت,2016-01-13,1015497812,108,31,0,36,1,951378,0,451378,500000,1015497812,0,480497812,535000000,286,276,276,285,951378,283,1.81992337164751
وصنعت,2016-01-16,2384383937,150,33,0,53,2,2138395,0,1488395,650000,2384383937,0,1658983937,725400000,297,290,290,297,2138395,297,4.89181561618062
وصنعت,2016-01-17,1430965727,175,44,0,49,1,1276854,0,1076854,200000,1430965727,0,1200965727,230000000,309,286,309,291,1276854,298,0.538116591928251
وصنعت,2016-01-18,605825689,73,17,1,26,1,308891,247382,536273,20000,338680489,267145200,583860689,21965000,298,284,298,291,556273,294,-1.33809099018733
وصنعت,2016-01-19,1394462903,140,38,1,46,1,1120202,100000,1200202,20000,1281308253,113154650,1371402903,23060000,309,298,298,299,1220202,304,3.34538878842676
وصنعت,2016-01-20,1638796236,119,34,0,45,2,1446761,0,1355979,90782,1638796236,0,1535219614,103576622,307,295,306,302,1446761,302,-0.874890638670166
وصنعت,2016-01-23,3561264715,210,51,1,69,3,2988851,20000,2868851,140000,3537864715,23400000,3397184982,164079733,316,309,309,316,3008851,315,4.50132391879965
وصنعت,2016-01-24,6823149365,250,68,1,76,1,5192116,300000,1614629,3877487,6450249365,372900000,2003433024,4819716341,331,316,316,331,5492116,331,4.89864864864865
وصنعت,2016-01-25,2858204797,164,48,1,65,1,1747520,500000,1345212,902308,2225204797,633000000,1714827503,1143377294,343,330,343,335,2247520,339,2.41545893719807
وصنعت,2016-01-26,6123363741,404,142,2,88,2,4778919,40845,3880605,939159,6071856506,51507235,4951243084,1172120657,351,328,328,328,4819764,338,-0.157232704402516
وصنعت,2016-01-27,7127295859,450,126,0,80,3,5834954,0,4946626,888328,7127295859,0,6048891177,1078404682,346,321,346,324,5834954,325,-3.85826771653543
وصنعت,2016-01-30,1154722535,141,51,0,49,0,957796,0,957796,0,1154722535,0,1154722535,0,330,310,319,312,957796,322,-0.982800982800983
وصنعت,2016-01-31,1031694847,133,37,2,38,0,774624,98599,873223,0,914756433,116938414,1031694847,0,321,310,314,321,873223,316,-1.65425971877585
وصنعت,2016-02-01,2479798705,109,17,1,52,0,988685,1000000,1988685,0,1231798705,1248000000,2479798705,0,332,324,324,332,1988685,332,4.87804878048781
وصنعت,2016-02-02,2612319608,195,60,1,73,1,1951568,100000,1958808,92760,2482653090,129666518,2495783048,116536560,347,333,346,338,2051568,339,2.0850040096231
وصنعت,2016-02-03,1759038891,128,34,1,43,0,1385736,1850,1387586,0,1756704191,2334700,1759038891,0,341,328,336,341,1387586,338,-0.392772977219167
وصنعت,2016-02-06,27030230074,475,60,6,126,3,6038410,14462725,5484322,15016813,7922233074,19107997000,7184008165,19846221909,354,334,337,354,20501135,351,3.94321766561514
وصنعت,2016-02-07,3974913492,119,23,2,50,2,2032524,841600,868124,2006000,2810980692,1163932800,1200615492,2774298000,368,368,368,368,2874124,368,4.93171471927162
وصنعت,2016-02-08,1742400000,63,14,0,31,2,1200000,0,645610,554390,1742400000,0,937425720,804974280,387,387,387,387,1200000,387,4.98915401301519
وصنعت,2016-02-09,14504207358,417,90,4,102,6,5145013,4500000,7958569,1686444,7724742941,6779464417,11967739933,2536467425,406,373,406,389,9645013,400,3.58126721763085
وصنعت,2016-02-10,10958408382,446,117,2,128,4,5337367,2000000,6027367,1310000,7952933402,3005474980,9033802562,1924605820,416,380,381,380,7337367,398,-0.664893617021277
وصنعت,2016-02-13,6900223555,271,48,0,91,2,4811833,0,4182135,629698,6900223555,0,6005311010,894912545,401,378,398,378,4811833,382,-4.01606425702811
وصنعت,2016-02-14,4489474521,208,30,2,62,4,2340939,814645,2065282,1090302,3335506881,1153967640,2948169641,1541304880,393,365,383,388,3155584,379,-0.767085076708508
وصنعت,2016-02-15,3383722291,148,29,2,61,2,1886799,405000,1652168,639631,2789847291,593875000,2440832614,942889677,398,386,389,389,2291799,393,3.72452565003514
وصنعت,2016-02-16,2492479351,139,40,2,36,0,1111149,635355,1746504,0,1580229937,912249414,2492479351,0,398,374,386,379,1746504,380,-3.31978319783198
وصنعت,2016-02-17,3059635923,169,27,2,61,0,1447092,669806,2116898,0,2091529398,968106525,3059635923,0,390,375,382,387,2116898,385,1.26138752627891
وصنعت,2016-02-20,3330317221,192,66,1,54,1,2187670,200000,2140288,247382,3055717221,274600000,2983572074,346745147,387,365,385,365,2387670,371,-3.46020761245675
وصنعت,2016-02-21,1690911247,99,36,1,26,0,978401,287275,1265676,0,1308835497,382075750,1690911247,0,365,354,355,355,1265676,356,-4.22939068100358
وصنعت,2016-02-22,1855730340,138,30,1,69,2,1228667,100000,1278467,50200,1716359479,139370861,1785349940,70380400,373,354,354,373,1328667,372,4.56586826347305
وصنعت,2016-02-23,1611415394,125,42,0,47,1,1147751,0,1144751,3000,1611415394,0,1607282344,4133050,389,360,389,364,1147751,374,0.501073729420186
وصنعت,2016-02-24,726174919,77,37,0,23,0,531197,0,531197,0,726174919,0,726174919,0,372,361,363,362,531197,369,-1.13960113960114
وصنعت,2016-02-27,1636609113,135,55,1,24,1,1178940,22000,1100940,100000,1605667403,30941710,1501205813,135403300,375,359,361,361,1200940,363,-1.80115273775216
وصنعت,2016-02-28,1058015518,93,35,1,32,2,755254,27000,448574,333680,1020225788,37789730,608541432,449474086,373,352,370,356,782254,361,-0.513573000733676
وصنعت,2016-02-29,926890206,95,45,2,20,2,571847,120000,587477,104370,765197193,161693013,786433366,140456840,364,353,364,354,691847,359,-0.663716814159292
وصنعت,2016-03-01,1495106297,112,47,0,31,1,1102392,0,907392,195000,1495106297,0,1228940241,266166056,366,357,359,360,1102392,361,0.593912397921307
وصنعت,2016-03-02,1492131038,122,43,1,28,0,995517,99000,1094517,0,1357590038,134541000,1492131038,0,370,359,359,365,1094517,363,0.590405904059041
وصنعت,2016-03-05,6642863143,386,134,2,51,0,3715766,1305000,5020766,0,4917538289,1725324854,6642863143,0,361,346,346,351,5020766,352,-2.93470286133529
وصنعت,2016-03-06,3595504450,264,87,1,64,0,2772939,15000,2787939,0,3576139450,19365000,3595504450,0,347,336,344,346,2787939,343,-2.49433106575964
وصنعت,2016-03-07,6508811298,305,78,3,65,0,4477417,511204,4988621,0,5839732120,669079178,6508811298,0,353,346,349,349,4988621,347,1.16279069767442
وصنعت,2016-03-08,5479504172,282,80,4,69,1,2275456,1939977,4205433,10000,2931705082,2547799090,5466304172,13200000,353,341,349,352,4215433,346,-0.383141762452107
وصنعت,2016-03-14,2143111144,77,27,3,31,0,894565,738822,1633387,0,1176406049,966705095,2143111144,0,374,366,366,366,1633387,369,6.66666666666667
وصنعت,2016-03-15,4033334453,178,37,3,67,0,1054668,2031006,3085674,0,1368853028,2664481425,4033334453,0,376,357,369,363,3085674,368,-0.38109756097561
وصنعت,2016-03-16,4923292501,204,29,1,82,0,2359519,1413598,3773117,0,3068779580,1854512921,4923292501,0,377,361,374,374,3773117,367,-0.153022188217291
وصنعت,2016-03-26,1891016365,85,30,1,33,0,907018,500000,1407018,0,1215933465,675082900,1891016365,0,382,369,377,379,1407018,378,2.98850574712644
وصنعت,2016-03-27,2169728315,127,47,2,47,0,1248464,352000,1600464,0,1689119134,480609181,2169728315,0,386,376,381,378,1600464,381,0.892857142857143
وصنعت,2016-03-28,537629012,51,22,0,24,0,407493,0,407493,0,537629012,0,537629012,0,373,369,371,371,407493,378,-0.884955752212389
وصنعت,2016-03-29,1396381911,95,15,1,57,1,332113,700000,1012113,20000,444992506,951389405,1369181911,27200000,385,369,369,385,1032113,380,0.595238095238095
وصنعت,2016-03-30,8206424238,289,40,4,101,1,4279229,1563152,5532381,310000,6000971562,2205452676,7766534238,439890000,399,375,375,399,5842381,395,3.92011834319527
وصنعت,2016-04-02,1628131181,103,35,2,46,1,792931,365382,1152313,6000,1120492320,507638861,1619816181,8315000,405,381,405,390,1158313,396,0.071174377224199
وصنعت,2016-04-03,2446001976,136,27,7,67,0,1177645,579802,1757447,0,1634043620,811958356,2446001976,0,402,385,398,402,1757447,392,-0.995732574679943
وصنعت,2016-04-04,2358582738,113,33,4,42,2,750925,933642,1514567,170000,1047326423,1311256315,2117802738,240780000,402,381,394,399,1684567,394,0.574712643678161
وصنعت,2016-04-05,21018281728,561,99,3,120,6,10302830,4014752,8502503,5815079,15116611288,5901670440,12470115598,8548166130,414,397,402,414,14317582,413,4.85714285714286
وصنعت,2016-04-06,30439210211,863,137,6,231,4,14563719,5214461,13283428,6494752,22411196215,8028013996,20431037379,10008172832,434,426,429,434,19778180,433,4.83651226158038
وصنعت,2016-04-09,4758464894,245,75,8,72,0,2221523,996159,3217682,0,3288012869,1470452025,4758464894,0,433,412,427,417,3217682,416,-3.89863547758285
وصنعت,2016-04-10,2718368495,141,34,4,49,0,993514,877100,1870614,0,1444146610,1274221885,2718368495,0,422,400,421,403,1870614,409,-1.7579445571332
وصنعت,2016-04-11,4067882726,145,33,11,44,1,1966673,841776,2308449,500000,2847186348,1220696378,3337842726,730040000,416,400,400,403,2808449,407,-0.344115622849277
وصنعت,2016-04-12,4112846458,186,55,12,42,0,1221825,1665986,2887811,0,1742648298,2370198160,4112846458,0,416,396,405,398,2887811,401,-1.65745856353591
وصنعت,2016-04-13,3254533769,139,31,14,42,0,1208983,1114014,2322997,0,1692740143,1561793626,3254533769,0,401,386,401,394,2322997,394,-1.61516853932584
وصنعت,2016-04-16,4702624760,234,64,4,56,2,2161070,1342112,2853182,650000,2905869088,1796755672,3835705906,866918854,399,374,399,376,3503182,378,-4.21127765881513
وصنعت,2016-04-17,972617335,85,34,0,44,1,712849,0,612849,100000,972617335,0,835117335,137500000,388,366,366,383,712849,381,0.968703427719821
وصنعت,2016-04-18,1898102453,111,50,3,34,0,829577,530300,1359877,0,1154783453,743319000,1898102453,0,399,381,391,386,1359877,393,3.02583025830258
وصنعت,2016-04-19,679636905,69,25,2,31,1,373102,116547,470649,19000,517399486,162237419,653036905,26600000,399,383,393,394,489649,392,-0.214899713467049
وصنعت,2016-04-20,1708339332,107,25,3,24,0,655468,588961,1244429,0,901711118,806628214,1708339332,0,399,383,399,386,1244429,386,-1.43575017946877
وصنعت,2016-04-23,1060665922,52,13,3,18,1,84276,684807,673265,95818,116244720,944421202,927574720,133091202,394,385,391,388,769083,387,0.291332847778587
وصنعت,2016-04-24,1670942779,90,21,2,43,0,473035,720651,1193686,0,661978919,1008963860,1670942779,0,399,388,391,389,1193686,394,1.67029774872912
وصنعت,2016-04-25,8198526526,177,12,6,37,2,196000,5579858,3133758,2642100,278645096,7919881430,4446744526,3751782000,405,388,388,403,5775858,399,1.35714285714286
وصنعت,2016-04-26,682105102,57,13,1,33,0,459979,20000,479979,0,653705102,28400000,682105102,0,405,395,405,405,479979,399,0.070472163495419
وصنعت,2016-04-27,3560476272,150,36,5,66,0,1526931,950480,2477411,0,2196056203,1364420069,3560476272,0,414,394,394,396,2477411,404,1.19718309859155
وصنعت,2016-04-30,1045040871,60,19,1,28,1,407408,326785,334193,400000,578585853,466455018,477191671,567849200,411,397,411,399,734193,402,-0.556715379262352
وصنعت,2016-05-01,976474428,52,15,2,21,2,213914,477736,447000,244650,301919876,674554552,631261588,345212840,406,396,406,399,691650,399,-0.699790062981106
وصنعت,2016-05-02,1539133630,84,14,3,34,1,315981,770170,668010,418141,447849380,1091284250,947219724,591913906,402,397,402,399,1086151,399,-0.140944326990839
وصنعت,2016-05-03,639580552,54,10,2,21,0,57420,394852,452272,0,81052140,558528412,639580552,0,405,396,398,396,452272,398,-0.070571630204658
وصنعت,2016-05-04,1188559415,70,12,2,29,2,168140,672589,340941,499788,237079107,951480308,482935620,705623795,407,394,402,394,840729,398,-0.141242937853107
وصنعت,2016-05-07,1593141015,58,8,2,24,0,151426,992283,1143709,0,211349204,1381791811,1593141015,0,396,389,394,396,1143709,392,-1.41442715700141
وصنعت,2016-05-08,396490459,41,9,1,26,1,65988,217810,258448,25350,92175049,304315410,361253959,35236500,397,390,390,393,283798,392,0.071736011477762
وصنعت,2016-05-09,137546669,27,6,1,11,0,24102,73729,97831,0,33810235,103736434,137546669,0,405,392,405,394,97831,393,0.07168458781362
وصنعت,2016-05-10,1204462496,58,7,2,37,0,156929,708894,865823,0,218002715,986459781,1204462496,0,396,388,388,394,865823,392,-0.286532951289398
وصنعت,2016-05-11,1864159436,89,3,1,31,0,150750,1183356,1334106,0,209277350,1654882086,1864159436,0,399,389,389,394,1334106,393,0.359195402298851
وصنعت,2016-05-14,1406901518,42,3,2,19,0,12661,987779,1000440,0,17771715,1389129803,1406901518,0,400,387,387,399,1000440,395,0.572655690765927
وصنعت,2016-05-15,2092549080,75,6,2,27,0,527530,972741,1500271,0,736677000,1355872080,2092549080,0,394,386,387,394,1500271,392,-0.711743772241993
وصنعت,2016-05-16,3433470108,98,6,11,32,1,191871,2265000,2054839,402032,269710658,3163759450,2868459052,565011056,397,391,391,391,2456871,393,0.14336917562724
وصنعت,2016-05-17,830968786,43,8,2,26,0,14730,580709,595439,0,20598460,810370326,830968786,0,395,387,387,394,595439,393,-0.071581961345741
وصنعت,2016-05-18,217810380,18,5,1,9,0,110158,44952,155110,0,154877580,62932800,217810380,0,397,394,397,394,155110,393,0.07163323782235
وصنعت,2016-05-21,899703382,54,8,5,25,1,65444,578458,443902,200000,91124069,808579313,619703382,280000000,396,389,391,394,643902,393,0
وصنعت,2016-05-23,506470494,49,12,3,20,0,252202,107673,359875,0,355724895,150745599,506470494,0,399,394,394,395,359875,394,0.214745884037223
وصنعت,2016-05-24,1311557207,69,11,4,30,0,225883,708027,933910,0,317519972,994037235,1311557207,0,398,394,394,396,933910,395,0.214285714285714
وصنعت,2016-05-25,895390429,59,12,8,27,2,202809,431193,407963,226039,286316962,609073467,576938201,318452228,400,396,397,400,634002,396,0.356379187455453
وصنعت,2016-05-28,276234773,41,11,2,26,0,54854,138872,193726,0,78044179,198190594,276234773,0,404,398,398,403,193726,397,0.213068181818182
وصنعت,2016-05-29,969181535,82,14,3,50,0,222115,450797,672912,0,316864717,652316818,969181535,0,415,398,398,408,672912,401,1.13394755492558
وصنعت,2016-05-30,2610859878,129,16,7,52,1,560634,1213707,1754832,19509,826398638,1784461240,2581986558,28873320,416,405,413,414,1774341,414,3.08339173090399
وصنعت,2016-05-31,1751421307,130,17,5,49,2,413598,770183,1161300,22481,611970853,1139450454,1718119577,33301730,421,414,416,416,1183781,416,0.543847722637661
وصنعت,2016-06-01,1566885813,79,8,7,39,1,139733,915710,1047433,8010,207673996,1359211817,1555183203,11702610,420,411,420,419,1055443,418,0.338066260987153
وصنعت,2016-06-05,2188854577,123,19,4,42,0,974938,491396,1466334,0,1454779458,734075119,2188854577,0,426,408,408,422,1466334,420,0.606469002695418
وصنعت,2016-06-06,1826320413,98,10,5,35,0,237327,981470,1218797,0,359184708,1467135705,1826320413,0,430,419,427,422,1218797,421,0.334896182183523
وصنعت,2016-06-07,895421120,41,9,3,19,0,92614,515000,607614,0,136027262,759393858,895421120,0,420,411,419,411,607614,418,-0.801068090787717
وصنعت,2016-06-08,219478882,21,6,1,17,1,48097,100000,144497,3600,70078982,149399900,214248082,5230800,420,409,420,409,148097,418,0
وصنعت,2016-06-11,1010172670,63,6,5,29,1,64385,635860,466245,234000,92991850,917180820,673349650,336823020,408,404,408,404,700245,411,-1.68236877523553
وصنعت,2016-06-12,947919824,38,2,4,29,0,341,648204,648545,0,489695,947430129,947919824,0,422,403,419,409,648545,411,0
وصنعت,2016-06-13,702740612,30,5,4,12,1,133048,356000,289048,200000,190744208,511996404,416707049,286033563,417,400,417,400,489048,408,-0.684462696783025
وصنعت,2016-06-14,378065228,42,8,2,17,0,22655,244000,266655,0,32145922,345919306,378065228,0,400,398,400,399,266655,406,-0.482425913163336
وصنعت,2016-06-15,489615354,41,13,2,12,0,119942,225000,344942,0,170575854,319039500,489615354,0,405,397,399,398,344942,404,-0.484764542936288
وصنعت,2016-06-18,565121100,42,8,2,18,0,251781,146000,397781,0,357812100,207309000,565121100,0,402,397,397,402,397781,403,-0.34794711203897
وصنعت,2016-06-19,557988288,34,5,2,21,1,194118,202206,223065,173259,275084778,282903510,313718359,244269929,401,387,392,393,396324,401,-0.558659217877095
وصنعت,2016-06-20,1747138765,52,6,2,14,1,82098,1166331,668920,579509,114759020,1632379745,935826165,811312600,399,383,399,394,1248429,394,-1.75561797752809
وصنعت,2016-06-21,729940366,34,3,4,9,1,7645,513527,88240,432932,10543000,719397366,123828079,606112287,398,380,380,394,521172,394,0.071479628305933
وصنعت,2016-06-22,611514331,36,7,0,21,1,424264,0,424196,68,611514331,0,611417431,96900,408,399,399,405,424264,398,1.07142857142857
وصنعت,2016-06-25,227110618,24,8,0,12,0,160284,0,160284,0,227110618,0,227110618,0,403,397,397,399,160284,398,0
وصنعت,2016-06-26,1419998624,87,13,1,49,0,188593,775188,963781,0,273925661,1146072963,1419998624,0,418,400,400,418,963781,411,3.32155477031802
وصنعت,2016-06-28,8584728283,170,22,4,54,4,3072665,2520000,3780165,1812500,4716528283,3868200000,5802540783,2782187500,432,431,432,432,5592665,432,4.99316005471956
وصنعت,2016-06-29,4341826436,176,36,6,54,0,1086366,1736511,2822877,0,1671672623,2670153813,4341826436,0,450,419,450,433,2822877,433,0.195439739413681
وصنعت,2016-07-02,931202054,64,11,3,29,0,195022,420619,615641,0,295604318,635597736,931202054,0,433,422,430,423,615641,429,-0.845253576072822
وصنعت,2016-07-03,3263085078,106,24,3,29,1,690250,1479200,1583541,585909,1034035125,2229049953,2382883851,880201227,430,418,428,418,2169450,423,-1.37704918032787
وصنعت,2016-07-04,1530451252,57,13,2,15,1,319482,700000,895391,124091,476414119,1054037133,1343901723,186549529,430,414,426,414,1019482,423,-0.132978723404255
وصنعت,2016-07-05,753911941,56,16,5,18,0,148497,354055,502552,0,223098488,530813453,753911941,0,426,414,416,422,502552,422,-0.066577896138482
وصنعت,2016-07-09,183843200,21,11,1,12,0,95564,30000,125564,0,139983200,43860000,183843200,0,422,408,422,419,125564,421,-0.266489007328448
وصنعت,2016-07-10,1301463141,87,9,6,40,3,596400,260000,576400,280000,908647941,392815200,877388141,424075000,431,419,419,425,856400,426,1.0688042752171
وصنعت,2016-07-11,8720114182,211,21,3,56,4,4915329,600000,3959522,1555807,7776024182,944090000,6250842666,2469271516,447,429,429,447,5515329,445,4.49438202247191
وصنعت,2016-07-12,65022717151,1197,198,14,186,15,27975879,11199944,19870990,19304833,46432639527,18590077624,32976694371,32046022780,467,459,467,467,39175823,467,4.99683744465528
وصنعت,2016-07-13,11100238078,360,67,2,104,4,6233880,404000,5119197,1518683,10426358078,673880000,8560738101,2539499977,475,459,470,470,6637880,470,0.72289156626506
وصنعت,2016-07-16,6291522297,204,61,3,55,2,2793565,1012927,3412718,393774,4642181097,1649341200,5629322169,662200128,477,453,470,454,3806492,465,-1.13636363636364
وصنعت,2016-07-17,4304010828,135,29,3,57,1,2067216,568436,2568117,67535,3381516868,922493960,4193253428,110757400,469,450,461,461,2635652,459,-1.20992135511192
وصنعت,2016-07-18,7675371196,211,43,5,45,3,1443856,3478916,4857474,65298,2255835995,5419535201,7573630740,101740456,452,437,452,437,4922772,439,-4.53153704837722
وصنعت,2016-07-19,164961316,36,17,1,16,0,101962,5000,106962,0,157303316,7658000,164961316,0,442,430,434,430,106962,438,-0.064143681847338
وصنعت,2016-07-20,1921113590,92,33,1,17,0,945521,300000,1245521,0,1458513590,462600000,1921113590,0,445,430,434,433,1245521,434,-1.02695763799743
وصنعت,2016-07-23,2593090495,86,35,0,18,1,1648561,0,1582238,66323,2593090495,0,2486973695,106116800,452,435,450,442,1648561,443,2.01037613488975
وصنعت,2016-07-24,1416897544,88,34,1,23,0,844311,70808,915119,0,1308348880,108548664,1416897544,0,442,431,442,431,915119,437,-1.20788302606484
وصنعت,2016-07-25,3953394462,143,44,8,31,2,1809561,790310,1451274,1148597,2747047851,1206346611,2211019323,1742375139,439,425,426,427,2599871,428,-2.12355212355212
وصنعت,2016-07-26,3992982738,133,44,8,28,2,1842106,797498,2365421,274183,2789524698,1203458040,3573670806,419311932,436,419,427,428,2639604,426,-0.525969756738988
وصنعت,2016-07-27,3970042148,127,16,1,63,4,2505205,9192,1559725,954672,3956061116,13981032,2459929730,1510112418,447,425,425,447,2514397,444,4.36219431592862
وصنعت,2016-07-31,21649493946,571,81,5,115,10,9253815,3873074,5186701,7940188,15270555414,6378938532,8541832010,13107661936,466,436,445,458,13126889,464,4.43318556048132
وصنعت,2016-08-01,8427433008,290,32,3,61,5,2057014,3050000,2818175,2288839,3395631859,5031801149,4650616112,3776816896,469,450,464,464,5107014,464,0.060642813826562
وصنعت,2016-08-02,4773747912,164,23,5,62,2,1264565,1630030,1948595,946000,2086360355,2687387557,3212659742,1561088170,466,462,464,466,2894595,464,-0.060606060606061
وصنعت,2016-08-03,6410032053,197,14,3,29,1,665592,3174050,2039642,1800000,1109527038,5300505015,3404032413,3005999640,472,459,459,470,3839642,470,1.21285627653123
وصنعت,2016-08-06,14110826465,357,42,4,109,3,6691342,1489757,7366836,814263,11580956705,2529869760,12699637689,1411188776,493,464,471,493,8181099,485,3.35530257639305
وصنعت,2016-08-07,8028041301,205,41,6,61,7,2479981,2180890,3118201,1542670,4275183971,3752857330,5375530395,2652510906,501,473,473,484,4660871,484,-0.173913043478261
وصنعت,2016-08-08,3395199836,130,21,1,58,1,1391851,558575,1850426,100000,2425206156,969993680,3221199836,174000000,492,484,490,488,1950426,490,1.10336817653891
وصنعت,2016-08-09,9124913667,210,13,3,45,3,861930,4392347,3754277,1500000,1495932440,7628981227,6527291297,2597622370,495,481,495,490,5254277,489,-0.229753015508328
وصنعت,2016-08-10,2622586858,104,8,2,40,3,389119,1118643,1127762,380000,677178267,1945408591,1962421858,660165000,492,487,487,490,1507762,489,0.115141047783535
وصنعت,2016-08-13,18219292615,427,34,13,94,4,4199663,5945889,7771520,2374032,7590124274,10629168341,13926242339,4293050276,513,487,491,513,10145552,505,3.27774583093732
وصنعت,2016-08-14,20492213258,511,63,12,70,6,6283688,4905422,9429390,1759720,11604086618,8888126640,17288291813,3203921445,526,505,526,507,11189110,515,1.94877505567929
وصنعت,2016-08-15,7131651293,90,24,1,23,1,3834631,100000,3634631,300000,6955651293,176000000,6601691695,529959598,515,494,515,495,3934631,510,-0.983069361004915
وصنعت,2016-08-16,17354327072,351,43,10,49,3,1576129,8472198,7848098,2200229,2727806580,14626520492,13562712117,3791614955,500,485,488,493,10048327,486,-4.74351902923332
وصنعت,2016-08-17,822213742,32,10,2,17,0,278355,202500,480855,0,476035262,346178480,822213742,0,487,479,480,487,480855,484,-0.405327156919514
وصنعت,2016-08-20,2614369776,103,14,9,21,0,447396,1100864,1548260,0,758398926,1855970850,2614369776,0,486,470,486,478,1548260,475,-1.80232558139535
وصنعت,2016-08-21,552115353,39,14,0,19,1,326020,0,286020,40000,552115353,0,484442353,67673000,484,473,484,477,326020,475,0.059206631142688
وصنعت,2016-08-22,823773536,39,13,2,13,0,417971,69423,487394,0,706629394,117144142,823773536,0,480,469,470,475,487394,475,0
وصنعت,2016-08-23,2422977263,78,10,4,19,0,667024,769826,1436850,0,1124634545,1298342718,2422977263,0,477,470,470,475,1436850,474,-0.236686390532544
وصنعت,2016-08-24,1138146472,45,14,3,12,1,217278,455477,558895,113860,367593440,770553032,944859656,193286816,478,473,477,475,672755,475,0.177935943060498
وصنعت,2016-08-27,2049747457,76,31,2,10,1,540250,700000,546839,693411,887147457,1162600000,914269839,1135477618,475,452,470,452,1240250,465,-2.13143872113677
وصنعت,2016-08-28,1795904773,81,14,3,23,3,166843,923446,529452,560837,273828001,1522076772,874701311,921203462,470,456,470,466,1090289,464,-0.302480338777979
وصنعت,2016-08-29,1491828345,85,14,5,23,1,405363,498948,737990,166321,668645656,823182689,1217446828,274381517,472,452,452,465,904311,464,0.060679611650486
وصنعت,2016-08-30,550381250,22,6,1,11,0,317150,15000,332150,0,525631250,24750000,550381250,0,472,464,464,467,332150,464,0.121285627653123
وصنعت,2016-08-31,1126999514,26,6,2,7,1,578823,100000,677516,1307,960899514,166100000,1124829894,2169620,473,467,467,467,678823,466,0.302846759539673
وصنعت,2016-09-03,1603476284,53,10,3,14,0,386100,586916,973016,0,637459800,966016484,1603476284,0,467,457,464,457,973016,464,-0.422705314009662
وصنعت,2016-09-04,858839334,37,9,1,11,0,454466,74410,528876,0,737258184,121581150,858839334,0,461,452,461,452,528876,461,-0.667070952092177
وصنعت,2016-09-05,603931122,16,8,1,6,0,275237,100000,375237,0,442731122,161200000,603931122,0,461,452,452,461,375237,458,-0.549450549450549
وصنعت,2016-09-06,685392872,26,8,1,15,0,116840,300000,416840,0,191143317,494249555,685392872,0,466,456,460,460,416840,460,0.306936771025169
وصنعت,2016-09-07,2241482020,80,14,3,12,1,464222,900000,561621,802601,764042010,1477440010,924827770,1316654250,474,459,466,459,1364222,462,0.550795593635251
وصنعت,2016-09-10,12730850,8,6,0,5,0,7810,0,7810,0,12730850,0,12730850,0,463,458,463,458,7810,462,0
وصنعت,2016-09-11,6439872631,196,16,2,9,2,688499,3226920,550848,3364571,1124986079,5314886552,899997779,5539874852,464,451,459,456,3915419,463,0.121728545343883
وصنعت,2016-09-13,1372621970,31,7,2,11,0,347282,500000,847282,0,562141770,810480200,1372621970,0,456,453,453,456,847282,458,-1.09422492401216
وصنعت,2016-09-14,3504514540,117,11,4,29,0,282021,1861193,2143214,0,455224781,3049289759,3504514540,0,467,446,455,464,2143214,460,0.491702519975415
وصنعت,2016-09-17,1646549077,49,4,2,11,0,67396,942003,1009399,0,109796636,1536752441,1646549077,0,461,454,454,460,1009399,459,-0.18348623853211
وصنعت,2016-09-18,1220353563,54,5,1,21,1,54974,679031,634005,100000,90893445,1129460118,1053345763,167007800,473,456,464,473,734005,464,1.16421568627451
وصنعت,2016-09-19,345003348,15,5,1,11,0,4591,200000,204591,0,7611121,337392227,345003348,0,475,459,475,475,204591,466,0.363416111447607
وصنعت,2016-09-21,2626189222,112,12,4,43,5,185404,1361428,1246832,300000,307429068,2318760154,2128415220,497774002,489,458,475,464,1546832,478,2.47435123717562
وصنعت,2016-09-24,430247779,26,6,1,8,0,53350,200000,253350,0,90524280,339723499,430247779,0,484,464,484,478,253350,478,0
وصنعت,2016-09-25,6048261352,195,18,4,13,3,282252,3300000,3546515,35737,463657208,5584604144,5988419926,59841426,478,454,466,464,3582252,475,-0.588928150765607
وصنعت,2016-09-26,750443349,25,9,2,11,0,85803,368435,454238,0,141274599,609168750,750443349,0,474,460,460,464,454238,471,-0.829383886255924
وصنعت,2016-09-27,499384120,25,7,1,15,0,67905,234726,302631,0,112086220,387297900,499384120,0,465,464,464,464,302631,469,-0.3584229390681
وصنعت,2016-09-28,1130505248,54,20,3,15,0,484175,205000,689175,0,794340248,336165000,1130505248,0,464,459,462,464,689175,465,-0.959232613908873
وصنعت,2016-10-01,1275946933,69,20,2,12,0,470842,315322,786164,0,761918671,514028262,1275946933,0,464,450,459,464,786164,459,-1.1501210653753
وصنعت,2016-10-02,653989876,29,10,2,10,0,154153,248786,402939,0,249316232,404673644,653989876,0,465,451,451,456,402939,459,-0.183710961420698
وصنعت,2016-10-03,1578757545,60,16,2,20,1,290708,676493,872201,95000,475095027,1103662518,1423717545,155040000,463,456,457,456,967201,459,0.122699386503067
وصنعت,2016-10-04,1766573637,68,25,2,21,1,912681,184700,997381,100000,1469188937,297384700,1606573637,160000000,464,447,462,450,1097381,454,-1.22549019607843
وصنعت,2016-10-05,916076029,69,25,2,10,2,368178,204911,532712,40377,588791766,327284263,851571633,64504396,464,448,450,450,573089,452,-0.372208436724566
وصنعت,2016-10-08,242011870,37,9,1,12,0,141517,10000,151517,0,226071870,15940000,242011870,0,450,448,450,448,151517,452,-0.062266500622665
وصنعت,2016-10-09,1306591940,47,6,1,19,1,274746,536380,531126,280000,439335469,867256471,856016940,450575000,459,438,438,452,811126,453,0.249221183800623
وصنعت,2016-10-10,774126496,42,20,1,10,2,385453,100000,336870,148583,614126496,160000000,538667850,235458646,456,442,455,444,485453,451,-0.372902423865755
وصنعت,2016-10-15,230445762,22,12,0,8,0,145694,0,145694,0,230445762,0,230445762,0,449,441,445,442,145694,450,-0.187149095446039
وصنعت,2016-10-16,535448040,37,3,3,18,2,5425,333265,195921,142769,8565326,526882714,309726558,225721482,448,440,447,448,338690,449,-0.3125
وصنعت,2016-10-17,1047163470,47,5,2,18,0,46355,600000,646355,0,74911250,972252220,1047163470,0,460,439,439,453,646355,453,0.877742946708464
وصنعت,2016-10-18,147085818,24,7,1,10,0,25665,66897,92562,0,40770536,106315282,147085818,0,450,445,447,446,92562,452,-0.124300807955252
وصنعت,2016-10-19,450942276,31,9,2,9,1,109513,174087,263600,20000,174398935,276543341,419172276,31770000,451,444,450,444,283600,451,-0.248911014312383
وصنعت,2016-10-22,509540765,64,30,2,16,1,234029,85619,302888,16760,373841507,135699258,482221965,27318800,459,443,450,448,319648,450,-0.124766063630692
وصنعت,2016-10-23,1436364560,51,25,0,8,3,906701,0,548570,358131,1436364560,0,868307236,568057324,448,445,446,445,906701,447,-0.811992504684572
وصنعت,2016-10-24,614932182,42,22,0,11,1,388742,0,286742,102000,614932182,0,453156182,161776000,447,442,446,447,388742,446,-0.125944584382872
وصنعت,2016-10-25,2004621908,113,48,2,16,2,1068920,203225,632145,640000,1686290908,318331000,996410023,1008211885,447,439,441,439,1272145,443,-0.630517023959647
وصنعت,2016-10-26,1544510606,96,24,2,36,2,624761,334459,588924,370296,1006751991,537758615,952215798,592294808,459,442,456,455,959220,451,1.71319796954315
وصنعت,2016-10-29,17925644893,420,82,9,63,4,6446866,4212444,1910478,8748832,10836155973,7089488920,3207360637,14718284256,473,461,461,473,10659310,473,4.92825951341235
وصنعت,2016-10-30,1851093089,140,63,1,20,0,1091149,50000,1141149,0,1770593089,80500000,1851093089,0,475,450,475,452,1141149,457,-3.38882282996433
وصنعت,2016-10-31,1296654241,87,7,2,28,1,483570,298024,557013,224581,802933163,493721078,922574149,374080092,469,461,461,467,781594,463,1.35384615384615
وصنعت,2016-11-01,1979608476,98,16,2,16,1,320289,886000,1196289,10000,521984814,1457623662,1963249551,16358925,466,454,464,458,1206289,462,-0.364298724954463
وصنعت,2016-11-02,513901534,68,14,1,10,0,209603,107000,316603,0,340132229,173769305,513901534,0,464,453,461,454,316603,460,-0.304692260816575
وصنعت,2016-11-05,970007647,87,7,4,18,0,136378,461500,597878,0,220722671,749284976,970007647,0,466,453,464,454,597878,458,-0.427872860635697
وصنعت,2016-11-06,670342731,52,11,3,18,0,80767,332000,412767,0,131121311,539221420,670342731,0,464,450,451,462,412767,458,-0.122774708410068
وصنعت,2016-11-07,2191853786,54,10,1,19,4,531886,800000,260495,1071391,879053786,1312800000,430034726,1761819060,472,461,461,464,1331886,463,1.16779348494161
وصنعت,2016-11-08,1596027679,54,9,3,25,2,780377,186371,557748,409000,1288532280,307495399,920254679,675773000,468,460,464,467,966748,464,0.243013365735115
وصنعت,2016-11-09,1541218859,93,38,3,17,1,610041,370000,940041,40000,960748859,580470000,1478494859,62724000,453,441,448,447,980041,446,-3.81818181818182
وصنعت,2016-11-12,148507077,25,13,1,11,1,89368,4987,89665,4690,140677487,7829590,141120327,7386750,450,442,443,450,94355,446,-0.063011972274732
وصنعت,2016-11-13,803442391,44,11,1,12,2,300611,207799,218410,290000,474542961,328899430,346008774,457433617,459,439,459,443,508410,446,-0.126103404791929
وصنعت,2016-11-14,1179977425,44,7,1,15,1,679049,60880,616514,123415,1083276145,96701280,983139030,196838395,455,445,445,454,739929,448,0.441919191919192
وصنعت,2016-11-15,680937390,27,9,1,10,1,300152,123720,370590,53282,483675150,197262240,595150610,85786780,461,448,461,448,423872,449,0.314267756128221
وصنعت,2016-11-16,1088737676,45,5,1,14,2,61550,620850,266442,415958,98540800,990196876,425335540,663402136,454,448,454,451,682400,449,0
وصنعت,2016-11-19,124755800,12,7,0,5,0,78605,0,78605,0,124755800,0,124755800,0,449,442,449,445,78605,449,-0.06265664160401
وصنعت,2016-11-21,445266059,22,7,1,9,0,269012,10000,279012,0,429286059,15980000,445266059,0,450,442,449,445,279012,449,0
وصنعت,2016-11-22,154401202,16,10,0,7,0,97603,0,97603,0,154401202,0,154401202,0,450,442,445,442,97603,448,-0.06269592476489
وصنعت,2016-11-23,1114873659,47,22,3,11,1,383101,326775,591351,118525,602250308,512623351,928761884,186111775,461,440,461,440,709876,445,-0.878293601003764
وصنعت,2016-11-26,488233978,30,9,1,16,1,208648,100000,108648,200000,328097910,160136068,173842505,314391473,454,441,445,454,308648,445,0
وصنعت,2016-11-27,359157807,16,6,1,10,0,127371,100000,227371,0,201007807,158150000,359157807,0,455,442,455,442,227371,445,0
وصنعت,2016-11-29,680041644,43,18,2,12,1,335337,100000,255337,180000,524319140,155722504,399554296,280487348,446,436,443,436,435337,443,-0.379746835443038
وصنعت,2016-12-03,1047132894,57,20,3,15,1,401246,282837,584083,100000,616034839,431098055,895432894,151700000,443,426,443,436,684083,436,-1.58831003811944
وصنعت,2016-12-04,846563018,39,24,2,7,0,422667,135000,557667,0,642263018,204300000,846563018,0,448,425,448,425,557667,432,-0.903808908973531
وصنعت,2016-12-05,1919476730,84,8,2,20,1,1097432,140710,1188142,50000,1702019530,217457200,1842147773,77328957,439,430,430,433,1238142,436,0.977198697068404
وصنعت,2016-12-06,2270724499,69,6,1,22,1,1064531,400000,1364531,100000,1649707840,621016659,2116363401,154361098,441,432,434,439,1464531,436,0
وصنعت,2016-12-07,972083630,69,14,2,23,1,574782,43423,420735,197470,905272601,66811029,661206443,310877187,450,432,432,433,618205,439,0.774193548387097
وصنعت,2016-12-10,82545421,14,9,1,6,0,46879,7000,53879,0,71842421,10703000,82545421,0,436,430,436,432,53879,439,-0.064020486555698
وصنعت,2016-12-11,1207284628,62,29,3,6,1,433825,368301,197966,604160,653299380,553985248,297589678,909694950,432,422,432,422,802126,429,-2.37027546444587
وصنعت,2016-12-12,795164181,56,14,2,9,2,347141,183450,490591,40000,520538158,274626023,735244181,59920000,427,420,421,421,530591,426,-0.721784776902887
وصنعت,2016-12-13,961105422,58,10,2,12,2,154706,487621,568602,73725,230447258,730658164,849167922,111937500,436,418,421,422,642327,423,-0.594844679444812
وصنعت,2016-12-14,1632348626,133,32,2,10,1,602228,519378,131606,990000,877239904,755108722,191512096,1440836530,422,406,406,408,1121606,410,-2.99202127659575
وصنعت,2016-12-18,92192040,16,5,1,6,0,61764,1734,63498,0,89599710,2592330,92192040,0,421,405,421,408,63498,410,0
وصنعت,2016-12-19,202197180,25,10,0,6,1,140136,0,80136,60000,202197180,0,115548915,86648265,410,403,403,405,140136,410,-0.137080191912269
وصنعت,2016-12-20,129603200,18,5,0,5,1,88670,0,45670,43000,129603200,0,66777860,62825340,414,410,410,410,88670,410,0
وصنعت,2016-12-21,188660210,14,7,1,8,0,120710,10000,130710,0,174230210,14430000,188660210,0,422,405,408,407,130710,410,-0.068634179821551
وصنعت,2016-12-24,1254879771,77,23,1,15,4,731973,120000,656264,195709,1076629771,178250000,966718043,288161728,422,407,422,413,851973,413,0.824175824175824
وصنعت,2016-12-25,1392884312,104,22,0,9,5,950433,0,251630,698803,1392884312,0,367255312,1025629000,421,408,421,415,950433,412,-0.136239782016349
وصنعت,2016-12-26,2307678110,79,15,1,11,2,984485,600000,150849,1433636,1428227500,879450610,220639226,2087038884,416,407,414,407,1584485,410,-0.68212824010914
وصنعت,2016-12-27,1464816205,39,5,1,8,1,992250,8600,368409,632441,1452311805,12504400,538222640,926593565,414,409,414,411,1000850,411,0.412087912087912
وصنعت,2016-12-28,1209544537,84,18,0,15,3,819372,0,579372,240000,1209544537,0,855839717,353704820,420,411,411,413,819372,414,0.683994528043776
وصنعت,2016-12-31,116445704,26,10,0,10,0,79749,0,79749,0,116445704,0,116445704,0,415,409,409,411,79749,414,-0.067934782608696
وصنعت,2017-01-01,458526893,38,7,0,10,1,315098,0,215098,100000,458526893,0,312746893,145780000,411,408,409,408,315098,413,-0.271923861318831
وصنعت,2017-01-02,366007340,37,11,0,7,1,251778,0,229778,22000,366007340,0,334000340,32007000,413,408,413,408,251778,412,-0.204498977505112
وصنعت,2017-01-03,466949262,35,6,0,7,3,318244,0,129744,188500,466949262,0,190071262,276878000,413,408,408,411,318244,412,0.068306010928962
وصنعت,2017-01-04,677374723,41,9,0,9,1,471473,0,377473,94000,683085923,0,547221846,135864077,411,407,411,407,467553,410,-0.409556313993174
وصنعت,2017-01-07,377819948,39,11,2,7,2,186208,76599,160277,102530,267783378,110036570,230952282,146867666,414,402,407,402,262807,409,-0.342700479780672
وصنعت,2017-01-08,74757937,16,8,1,9,0,45200,7043,52243,0,64721662,10036275,74757937,0,408,401,402,408,52243,409,-0.068775790921596
وصنعت,2017-01-09,63672500,14,3,1,8,0,28378,15500,43878,0,41289500,22383000,63672500,0,410,403,403,410,43878,409,0
وصنعت,2017-01-11,914926270,41,8,2,13,1,324060,311182,385242,250000,466475677,448450593,555705870,359220400,408,402,408,408,635242,407,-0.481761871988988
وصنعت,2017-01-14,440652939,35,5,1,18,0,247463,54070,301533,0,362260509,78392430,440652939,0,419,404,404,419,301533,408,0.276625172890733
وصنعت,2017-01-15,113290408,21,7,0,10,0,76806,0,76806,0,113290408,0,113290408,0,418,408,408,416,76806,408,0.137931034482759
وصنعت,2017-01-16,165668936,26,8,0,13,0,112787,0,112787,0,165668936,0,165668936,0,416,411,411,416,112787,409,0.137741046831956
وصنعت,2017-01-17,408543750,35,14,0,8,0,279212,0,279212,0,408543750,0,408543750,0,414,409,414,414,279212,410,0.137551581843191
وصنعت,2017-01-18,409925892,36,12,0,19,0,278644,0,278644,0,409925892,0,409925892,0,419,409,414,416,278644,411,0.274725274725275
وصنعت,2017-01-21,83328948,8,5,0,3,0,57048,0,57048,0,83328948,0,83328948,0,412,411,412,411,57048,411,0
وصنعت,2017-01-22,153508513,20,12,1,8,0,71142,34286,105428,0,103793813,49714700,153508513,0,412,408,411,408,105428,411,0
وصنعت,2017-01-23,134442144,17,3,0,10,0,91366,0,91366,0,134442144,0,134442144,0,418,408,408,416,91366,411,0.068493150684932
وصنعت,2017-01-24,198972264,30,8,0,16,0,136068,0,136068,0,198972264,0,198972264,0,412,411,412,411,136068,411,0
وصنعت,2017-01-25,333821070,34,12,0,5,2,229797,0,134797,95000,333821070,0,195629235,138191835,412,402,412,410,229797,410,-0.136892539356605
وصنعت,2017-01-28,12824250,3,3,0,3,0,8825,0,8825,0,12824250,0,12824250,0,409,408,408,409,8825,410,0
وصنعت,2017-01-29,117663135,31,10,0,4,0,81800,0,81800,0,117663135,0,117663135,0,408,402,408,405,81800,410,-0.068540095956134
وصنعت,2017-01-30,252896223,29,13,0,12,0,174779,0,174779,0,252896223,0,252896223,0,410,402,405,410,174779,410,-0.137174211248285
وصنعت,2017-01-31,214268122,19,9,0,11,0,148554,0,148554,0,214268122,0,214268122,0,409,403,403,409,148554,409,-0.137362637362637
وصنعت,2017-02-01,158269469,14,6,0,3,0,109689,0,109689,0,158269469,0,158269469,0,410,403,407,403,109689,409,-0.068775790921596
وصنعت,2017-02-04,653809841,41,9,3,10,2,331732,128530,57836,402426,472332541,181477300,83090149,570719692,408,397,404,399,460262,405,-0.825877494838266
وصنعت,2017-02-05,210777518,20,5,2,11,1,129318,19902,101646,47574,182715698,28061820,143588364,67189154,398,397,397,397,149220,404,-0.277585010409438
وصنعت,2017-02-06,1633922176,39,7,3,10,1,93200,1046172,150372,989000,131812126,1502110050,212729176,1421193000,404,397,397,404,1139372,403,-0.208768267223382
وصنعت,2017-02-07,195940274,24,8,2,9,0,118171,20258,138429,0,167363294,28576980,195940274,0,399,397,397,397,138429,403,-0.139470013947001
وصنعت,2017-02-08,161654690,32,17,1,11,0,100211,15000,115211,0,140654690,21000000,161654690,0,397,394,397,395,115211,402,-0.209497206703911
وصنعت,2017-02-11,214016030,28,15,1,9,0,118097,35000,153097,0,165016030,49000000,214016030,0,394,391,394,394,153097,401,-0.279916025192442
وصنعت,2017-02-12,1410540194,103,39,1,2,1,1020412,15600,20011,1016001,1389389794,21150400,27095191,1383445003,391,381,391,381,1036012,385,-3.85964912280702
وصنعت,2017-02-13,357934439,24,9,1,10,1,217771,43410,140541,120640,298130319,59804120,191439959,166494480,389,370,370,387,261181,385,0
وصنعت,2017-02-14,977081540,26,11,1,4,1,562563,150000,40777,671786,771581540,205500000,55992720,921088820,388,383,383,385,712563,386,0.072992700729927
وصنعت,2017-02-15,1719219330,133,29,0,3,1,1280561,0,21565,1258996,1719219330,0,29431784,1689787546,385,371,385,371,1280561,378,-2.04230488694384
وصنعت,2017-02-18,506032037,36,8,0,20,0,365625,0,365625,0,506032037,0,506032037,0,394,375,375,393,365625,381,0.893521965748325
وصنعت,2017-02-19,270723740,30,12,1,8,1,187552,10000,177552,20000,257073740,13650000,242723740,28000000,394,383,394,392,197552,382,0.22140221402214
وصنعت,2017-02-20,217356470,38,18,0,6,1,160474,0,95974,64500,217356470,0,130005470,87351000,384,376,384,380,160474,382,0
وصنعت,2017-02-21,605368452,38,16,0,7,2,444164,0,108664,335500,605368452,0,148088758,457279694,388,382,388,386,444164,383,0.147275405007364
وصنعت,2017-02-22,2226312098,141,38,1,36,1,1550428,10000,1520428,40000,2212032098,14280000,2169192098,57120000,402,391,394,402,1560428,401,4.92647058823529
وصنعت,2017-02-25,768946127,61,26,0,13,2,542867,0,172344,370523,768946127,0,247996703,520949424,413,394,402,394,542867,400,-0.350385423966363
وصنعت,2017-02-26,1295593120,110,42,0,21,1,918243,0,527654,390589,1295593120,0,745422939,550170181,407,391,400,394,918243,398,-0.562587904360056
وصنعت,2017-02-27,3191325735,173,67,1,24,4,2164931,30000,474668,1720263,3147495735,43830000,692345751,2498979984,414,405,408,408,2194931,409,2.82885431400283
وصنعت,2017-02-28,1679701433,114,40,2,31,5,763927,365779,608453,521253,1130196067,549505366,907188998,772512435,424,411,415,421,1129706,418,2.13204951856946
وصنعت,2017-03-01,1963045748,80,25,2,20,4,269873,1039100,122973,1186000,404010175,1559035573,183535748,1779510000,425,411,411,422,1308973,422,1.01010101010101
وصنعت,2017-03-04,2891256923,137,24,2,23,3,1813622,112471,813988,1112105,2722707519,168549404,1221189928,1670066995,425,418,422,421,1926093,422,0.066666666666667
وصنعت,2017-03-05,451886815,47,30,0,16,0,305972,0,305972,0,451886815,0,451886815,0,421,408,420,418,305972,421,-0.399733510992672
وصنعت,2017-03-06,3597708684,213,91,0,21,3,2504305,0,859981,1644324,3597708684,0,1231686686,2366021998,419,401,418,408,2504305,404,-3.87959866220736
وصنعت,2017-03-13,588265199,69,32,0,21,0,508246,0,508246,0,588265199,0,588265199,0,414,389,389,393,508246,400,-1.09519797809604
وصنعت,2017-03-14,61195859,17,8,0,8,0,52228,0,52228,0,61195859,0,61195859,0,401,397,397,398,52228,400,0
وصنعت,2017-03-15,102212125,20,12,0,9,0,85290,0,85290,0,102212125,0,102212125,0,412,400,405,412,85290,401,0.170357751277683
وصنعت,2017-03-18,106904405,18,8,0,12,0,87395,0,87395,0,106904405,0,106904405,0,420,406,418,419,87395,402,0.255102040816327
وصنعت,2017-03-25,7064010,2,2,0,2,0,5870,0,5870,0,7064010,0,7064010,0,417,409,409,417,5870,402,0
وصنعت,2017-03-26,97973030,17,10,0,8,0,80917,0,80917,0,97973030,0,97973030,0,420,411,420,414,80917,402,0.169635284139101
وصنعت,2017-03-27,197094988,23,15,0,6,0,163766,0,163766,0,197094988,0,197094988,0,416,409,412,409,163766,403,0.254022015241321
وصنعت,2017-03-28,365864834,28,12,0,7,0,301998,0,301998,0,365864834,0,365864834,0,419,409,413,409,301998,406,0.591216216216216
وصنعت,2017-03-29,389042755,33,15,0,12,0,321359,0,321359,0,389042755,0,389042755,0,414,412,412,412,321359,407,0.419815281276239
وصنعت,2017-04-03,269277060,44,12,1,21,1,211760,5000,207510,9250,263067060,6210000,257844060,11433000,427,413,413,425,216760,410,0.668896321070234
وصنعت,2017-04-04,674289240,81,34,0,22,0,538822,0,538822,0,674289240,0,674289240,0,429,421,427,423,538822,417,1.74418604651163
وصنعت,2017-04-05,301904341,45,24,0,15,1,242690,0,240000,2690,301904341,0,298574121,3330220,431,421,431,428,242690,419,0.326530612244898
وصنعت,2017-04-08,167593170,36,18,0,14,0,134577,0,134577,0,167593170,0,167593170,0,429,422,422,423,134577,419,0.16273393002441
وصنعت,2017-04-09,379132421,46,16,0,17,0,304679,0,304679,0,379132421,0,379132421,0,428,422,428,423,304679,420,0.243704305442729
وصنعت,2017-04-10,1596228334,149,41,0,35,3,1254140,0,944855,309285,1596228334,0,1197254684,398973650,441,421,424,436,1254140,434,3.16045380875203
وصنعت,2017-04-12,552743979,50,24,0,15,1,432791,0,426791,6000,552743979,0,545123979,7620000,451,431,441,436,432791,434,0.157109190887667
وصنعت,2017-04-15,634416785,70,28,1,20,0,247144,250000,497144,0,315127493,319289292,634416785,0,439,429,439,436,497144,434,0
وصنعت,2017-04-16,368058201,65,16,1,29,0,170779,117000,287779,0,218806201,149252000,368058201,0,439,428,429,435,287779,435,0.07843137254902
وصنعت,2017-04-17,746885306,68,21,5,11,0,253512,337312,590824,0,320755122,426130184,746885306,0,441,428,441,428,590824,433,-0.470219435736677
وصنعت,2017-04-18,457542521,59,26,2,16,2,257522,100000,257522,100000,330342521,127200000,330326521,127216000,441,433,439,435,357522,434,0.236220472440945
وصنعت,2017-04-19,678622159,58,30,2,9,1,494086,45688,39774,500000,620842279,57779880,50262775,628359384,440,425,429,426,539774,431,-0.549882168106834
وصنعت,2017-04-22,1612288410,87,33,0,19,3,1259390,0,359290,900100,1612288410,0,462378597,1149909813,442,429,431,432,1259390,436,1.10584518167457
وصنعت,2017-04-23,453813968,34,15,0,18,0,354494,0,354494,0,453813968,0,453813968,0,441,426,426,436,354494,436,0
وصنعت,2017-04-24,1095529344,52,12,0,30,0,815126,0,815126,0,1095529344,0,1095529344,0,458,458,458,458,815126,451,3.359375
وصنعت,2017-04-26,5637141213,100,36,2,11,2,3858417,200000,411699,3646718,5359341213,277800000,571849911,5065291302,473,473,473,473,4058417,473,4.98866213151927
وصنعت,2017-04-29,7677986604,327,108,0,56,9,5426106,0,2691769,2734337,7677986604,0,3800688873,3877297731,490,468,490,469,5426106,482,1.87185025197984
وصنعت,2017-04-30,768001895,91,35,1,31,2,456108,100000,458507,97601,629501895,138500000,632430101,135571794,475,464,475,467,556108,476,-1.13074204946996
وصنعت,2017-05-01,488401228,55,24,0,18,2,354584,0,294584,60000,488401228,0,405579608,82821620,473,463,467,467,354584,474,-0.428877769835597
وصنعت,2017-05-02,1126483705,79,28,0,18,1,824130,0,807330,16800,1126483705,0,1103350105,23133600,470,461,467,466,824130,468,-1.2921751615219
وصنعت,2017-05-03,1118643915,62,22,0,25,1,813823,0,309611,504212,1118643915,0,425189783,693454132,476,463,463,466,813823,468,0
وصنعت,2017-05-06,1974694925,124,13,0,22,1,1441542,0,941542,500000,1974694925,0,1289694925,685000000,468,463,466,467,1441542,467,-0.363636363636364
وصنعت,2017-05-07,942871908,101,37,0,30,1,683069,0,660093,22976,942871908,0,911188004,31683904,484,463,479,464,683069,469,0.437956204379562
وصنعت,2017-05-08,613167929,59,21,0,7,0,452197,0,452197,0,613167929,0,613167929,0,464,460,463,460,452197,466,-0.581395348837209
وصنعت,2017-05-09,881541532,31,14,0,9,0,650345,0,650345,0,881541532,0,881541532,0,467,461,465,467,650345,464,-0.511695906432749
وصنعت,2017-05-10,287121860,46,17,1,13,1,200313,10000,136313,74000,273397860,13724000,186323362,100798498,473,463,467,463,210313,464,0.073475385745775
وصنعت,2017-05-13,1580724980,62,15,0,12,1,1163950,0,647738,516212,1580724980,0,881479914,699245066,467,460,463,463,1163950,463,-0.293685756240822
وصنعت,2017-05-14,375655547,27,9,0,12,2,276316,0,250711,25605,375655547,0,340749146,34906401,468,461,463,464,276316,463,0
وصنعت,2017-05-15,3324268415,52,8,2,14,1,82099,2327500,159599,2250000,112183435,3212084980,219268415,3105000000,473,462,463,468,2409599,470,1.620029455081
وصنعت,2017-05-16,455081758,43,16,1,15,0,229454,100000,329454,0,316418364,138663394,455081758,0,473,464,467,470,329454,470,0
وصنعت,2017-05-17,435548403,37,17,0,12,1,317990,0,238546,79444,435548403,0,326755997,108792406,473,464,469,470,317990,469,-0.217391304347826
وصنعت,2017-05-20,832298157,54,22,2,23,0,589763,5010,594773,0,825374057,6924100,832298157,0,480,468,477,478,594773,473,0.798838053740014
وصنعت,2017-05-21,794167024,75,22,0,23,2,563822,0,510072,53750,794167024,0,717993024,76174000,484,477,477,480,563822,476,0.720461095100865
وصنعت,2017-05-22,1592708543,131,23,0,29,5,1129328,0,890220,239108,1592708543,0,1256744760,335963783,489,477,479,478,1129328,480,0.858369098712446
وصنعت,2017-05-23,3425046295,180,38,3,27,7,1884028,521000,418381,1986647,2683901594,741144701,595593859,2829452436,489,479,479,484,2405028,485,0.992907801418439
وصنعت,2017-05-24,22983686482,717,93,4,37,37,5633539,10587850,879946,15341443,7952573703,15031112779,1243813917,21739872565,488,477,485,484,16221389,483,-0.491573033707865
وصنعت,2017-06-03,222310744,33,20,0,7,1,206391,0,205391,1000,222310744,0,221220744,1090000,473,461,473,467,206391,468,-3.06030603060306
وصنعت,2017-06-06,942083711,83,29,2,18,0,523563,366161,889724,0,556530786,385552925,942083711,0,469,455,464,458,889724,464,-0.835654596100279
وصنعت,2017-06-07,1244001256,90,23,2,25,1,804246,394568,1198264,550,835875040,408126216,1243431456,569800,457,446,457,452,1198814,455,-1.87265917602996
وصنعت,2017-06-10,454971076,88,25,1,16,0,385659,56000,441659,0,396861308,58109768,454971076,0,453,445,448,447,441659,454,-0.381679389312977
وصنعت,2017-06-11,967418283,82,27,1,15,0,928363,17150,945513,0,949809533,17608750,967418283,0,448,443,448,444,945513,449,-1.0536398467433
وصنعت,2017-06-12,166523428,26,10,0,13,0,162688,0,162688,0,166523428,0,166523428,0,447,444,444,447,162688,448,-0.096805421103582
وصنعت,2017-06-13,788850137,78,21,1,21,1,720768,45000,715768,50000,742350137,46500000,737196657,51653480,459,443,443,448,765768,448,-0.096899224806202
وصنعت,2017-06-14,677014328,66,29,1,10,1,626346,20000,246031,400315,656014328,21000000,256442188,420572140,460,450,460,456,646346,450,0.5819592628516
وصنعت,2017-06-17,517211441,49,27,1,8,1,393340,100000,190340,303000,412736441,104475000,200252321,316959120,469,453,458,456,493340,452,0.289296046287367
وصنعت,2017-06-18,829600470,58,24,3,7,1,505116,283560,387676,401000,533022870,296577600,408968635,420631835,467,452,456,452,788676,454,0.480769230769231
وصنعت,2017-06-19,1085646427,81,32,3,18,1,822428,229940,852368,200000,846418051,239228376,881446427,204200000,456,444,452,450,1052368,450,-0.76555023923445
وصنعت,2017-06-20,387456365,30,17,2,9,1,162325,215000,318325,59000,165945615,221510750,326155365,61301000,451,444,445,450,377325,450,-0.192864030858245
وصنعت,2017-06-21,292936991,30,12,2,12,0,235643,49890,285533,0,241749741,51187250,292936991,0,450,445,445,445,285533,449,-0.096618357487923
وصنعت,2017-06-24,117616100,20,10,1,8,0,72354,42540,114894,0,74140220,43475880,117616100,0,456,444,456,444,114894,449,-0.096711798839459
وصنعت,2017-06-25,400307677,25,9,2,6,0,369087,22570,391657,0,377221137,23086540,400307677,0,447,444,447,444,391657,448,-0.193610842207164
وصنعت,2017-06-28,623352077,69,30,0,10,1,611420,0,260464,350956,623352077,0,265049801,358302276,444,439,444,443,611420,446,-0.387972841901067
وصنعت,2017-07-01,71519199,20,10,1,7,1,55463,14500,32906,37057,56691699,14827500,33643021,37876178,451,443,451,443,69963,446,0
وصنعت,2017-07-02,223160466,30,9,1,12,1,194908,25000,143665,76243,197660966,25499500,145585852,77574614,443,437,437,440,219908,446,-0.097370983446933
وصنعت,2017-07-03,34793802,10,8,0,7,0,34201,0,34201,0,34793802,0,34793802,0,443,440,440,443,34201,446,0
وصنعت,2017-07-04,421927738,66,38,2,13,0,328973,91500,420473,0,329002238,92925500,421927738,0,443,432,441,439,420473,444,-0.487329434697856
وصنعت,2017-07-05,271428777,52,11,1,11,1,135196,131850,201725,65321,136947127,134481650,205283575,66145202,448,435,448,442,267046,443,-0.09794319294809
وصنعت,2017-07-08,240087157,39,15,2,13,0,79714,158000,237714,0,80670327,159416830,240087157,0,443,432,436,437,237714,443,-0.098039215686275
وصنعت,2017-07-09,771376949,68,18,2,16,1,585616,171932,573782,183766,596135028,175241921,583935629,187441320,447,439,441,441,757548,443,0
وصنعت,2017-07-10,112784916,42,14,1,16,1,79162,31135,105297,5000,80912120,31872796,107634916,5150000,447,442,447,443,110297,443,0
وصنعت,2017-07-11,449733858,34,15,1,12,0,436618,7738,444356,0,441796574,7937284,449733858,0,447,435,441,447,444356,442,-0.196270853778214
وصنعت,2017-07-12,272874060,32,17,0,8,0,270044,0,270044,0,272874060,0,272874060,0,443,438,439,439,270044,441,-0.098328416912488
وصنعت,2017-07-15,174870074,27,13,0,10,0,171712,0,171712,0,174870074,0,174870074,0,445,439,445,439,171712,441,0
وصنعت,2017-07-16,369215452,55,28,1,9,1,337716,30000,267716,100000,338977556,30237896,269080342,100135110,443,434,440,441,367716,440,-0.196850393700787
وصنعت,2017-07-17,816537956,84,26,1,14,2,574403,242507,271910,545000,572116283,244421673,273788596,542749360,443,430,439,438,816910,437,-0.690335305719921
وصنعت,2017-07-18,465268440,49,24,2,10,2,402921,62424,125345,340000,402598280,62670160,125207341,340061099,443,432,435,435,465345,437,-0.198609731876862
وصنعت,2017-07-19,394350772,41,13,1,10,2,315568,70000,128068,257500,323065160,71285612,130467920,263882852,446,435,439,446,385568,438,0.398009950248756
وصنعت,2017-07-22,926106246,56,28,1,9,1,909107,4204,318311,595000,921830766,4275480,323074602,603031644,447,438,447,439,913311,440,0.297324083250743
وصنعت,2017-07-23,291969844,55,26,1,9,1,282460,5092,285486,2066,286760728,5209116,289862524,2107320,451,439,440,439,287552,440,0.098814229249012
وصنعت,2017-07-24,233757058,32,16,1,12,0,213702,14079,227781,0,219382399,14374659,233757058,0,454,443,443,452,227781,441,0.197433366238894
وصنعت,2017-07-25,226111609,56,28,1,23,1,216509,1792,169837,48464,224255097,1856512,176064447,50047162,455,444,452,448,218301,442,0.295566502463054
وصنعت,2017-07-26,641353342,79,42,1,13,1,628210,1212,464457,164965,640138918,1214424,472343217,169010125,455,435,447,439,629422,442,0
وصنعت,2017-07-29,303504681,48,29,1,7,0,292450,8788,301238,0,294655165,8849516,303504681,0,443,435,443,435,301238,441,-0.196463654223969
وصنعت,2017-07-30,257833770,28,11,1,8,0,155935,100000,255935,0,157333770,100500000,257833770,0,441,436,436,440,255935,441,-0.098425196850394
وصنعت,2017-07-31,231472505,37,25,1,11,0,198724,31500,230224,0,199723005,31749500,231472505,0,440,435,435,437,230224,440,-0.098522167487685
وصنعت,2017-08-01,580711658,51,27,1,7,1,329289,250000,179289,400000,330211658,250500000,180003824,400707834,440,435,438,435,579289,439,-0.394477317554241
وصنعت,2017-08-02,1049363680,72,17,1,25,0,504150,537394,1041544,0,505881811,543481869,1049363680,0,447,435,439,447,1041544,438,-0.099009900990099
وصنعت,2017-08-06,1053796325,46,18,1,14,2,121696,908501,239295,790902,123431800,930364525,245225905,808570420,450,438,446,446,1030197,442,0.792864222001982
وصنعت,2017-08-07,741844734,65,12,2,32,2,107557,610277,452165,265669,110694149,631150585,469296027,272548707,455,443,448,443,717834,445,0.688298918387414
وصنعت,2017-08-08,86105231,15,7,1,9,0,83007,380,83387,0,85721051,384180,86105231,0,449,439,445,449,83387,445,0
وصنعت,2017-08-09,1914027784,167,35,3,63,1,595310,1213059,1508369,300000,631525292,1282502492,1598227784,315800000,467,447,454,467,1808369,460,3.3203125
وصنعت,2017-08-12,1361494046,88,31,2,24,1,808757,459530,371530,896757,867813936,493680110,405741556,955752490,480,455,462,463,1268287,464,1.03969754253308
وصنعت,2017-08-13,457239290,40,10,3,13,1,184694,241018,182562,243150,196863410,260375880,196599900,260639390,475,460,469,464,425712,465,0.09354536950421
وصنعت,2017-08-14,416297538,45,7,3,11,2,181000,212530,221038,172492,191101000,225196538,233710526,182587012,465,456,456,458,393530,464,-0.280373831775701
وصنعت,2017-08-15,672890965,64,7,2,15,1,94573,543536,562095,76014,99091961,573799004,592365565,80525400,464,454,460,464,638109,462,-0.374882849109653
وصنعت,2017-08-16,137266020,19,6,1,9,0,115073,15250,130323,0,121253520,16012500,137266020,0,464,456,460,457,130323,461,-0.094073377234243
وصنعت,2017-08-19,245806930,33,7,1,9,0,141637,93003,234640,0,147885143,97921787,245806930,0,464,452,452,454,234640,460,-0.188323917137476
وصنعت,2017-08-20,204031210,33,7,1,10,0,111467,82682,194149,0,116812218,87218992,204031210,0,466,452,456,452,194149,460,-0.09433962264151
وصنعت,2017-08-21,71384822,27,12,1,13,0,56245,12504,68749,0,58210868,13173954,71384822,0,460,447,450,460,68749,460,-0.094428706326723
وصنعت,2017-08-22,60978620,11,6,0,3,0,58878,0,58878,0,60978620,0,60978620,0,452,450,452,450,58878,459,-0.094517958412098
وصنعت,2017-08-23,102433950,12,6,1,5,1,77808,20000,64006,33802,81633950,20800000,66941850,35492100,456,452,456,456,97808,459,-0.094607379375591
وصنعت,2017-08-26,117441950,21,10,2,9,0,29900,81429,111329,0,31376500,86065450,117441950,0,462,452,456,452,111329,459,0
وصنعت,2017-08-27,258658415,20,3,1,13,1,76496,167471,227769,16198,81004498,177653917,241423743,17234672,467,447,456,467,243967,459,0.09469696969697
وصنعت,2017-08-28,32700595,12,8,0,6,0,31084,0,31084,0,32700595,0,32700595,0,471,452,471,452,31084,459,0
وصنعت,2017-08-29,190135900,21,8,2,10,0,128982,52573,181555,0,134501770,55634130,190135900,0,462,450,455,460,181555,459,-0.094607379375591
وصنعت,2017-08-30,66055166,11,3,1,7,0,61406,467,61873,0,65558114,497052,66055166,0,464,459,459,464,61873,459,0
وصنعت,2017-09-02,1154602190,39,9,3,10,0,135800,972919,1108719,0,141643550,1012958640,1154602190,0,464,450,456,460,1108719,455,-0.852272727272727
وصنعت,2017-09-03,269834388,48,18,2,10,1,214367,44935,92858,166444,222760742,47073646,97042039,172792349,458,447,452,447,259302,454,-0.095510983763133
وصنعت,2017-09-04,795751120,95,44,2,10,1,652047,123342,352842,422547,668544202,127206918,361213178,434537942,459,439,459,439,775389,450,-0.860420650095602
وصنعت,2017-09-05,183902636,22,17,0,4,1,179849,0,17599,162250,183902636,0,18102186,165800450,455,440,440,443,179849,450,-0.096432015429123
وصنعت,2017-09-06,816442501,46,24,1,7,3,202326,591750,248700,545376,204191251,612251250,252554586,563887915,454,437,442,437,794076,449,-0.28957528957529
وصنعت,2017-09-10,756928445,47,3,1,15,1,55300,677241,490891,241650,56912000,700016445,508959170,247969275,460,441,445,450,732541,449,0
وصنعت,2017-09-11,2163959360,108,37,2,16,1,1288352,859548,216363,1931537,1292651350,871308010,224579310,1939380050,455,434,454,452,2147900,437,-2.51694094869313
وصنعت,2017-09-12,192101516,34,5,2,16,1,17263,171000,161233,27030,17666764,174434752,164530916,27570600,447,443,443,447,188263,438,0.099304865938431
وصنعت,2017-09-13,213326253,27,10,1,16,0,109344,100000,209344,0,111326253,102000000,213326253,0,444,439,440,442,209344,438,0.099206349206349
وصنعت,2017-09-16,174064435,18,8,2,11,0,24045,142903,166948,0,24723890,149340545,174064435,0,456,440,451,443,166948,440,0.297324083250743
وصنعت,2017-09-17,344305819,30,13,1,9,0,269353,67500,336853,0,274050819,70255000,344305819,0,453,441,441,447,336853,440,0.197628458498024
وصنعت,2017-09-18,868850092,69,30,2,7,1,471130,380501,151631,700000,476779142,392070950,154901616,713948476,451,439,441,451,851631,442,0.29585798816568
وصنعت,2017-09-19,596023682,52,30,1,9,0,442278,143800,586078,0,448614792,147408890,596023682,0,452,437,444,437,586078,442,0
وصنعت,2017-09-20,196674484,25,10,1,11,0,162402,29701,192103,0,166379464,30295020,196674484,0,451,443,443,450,192103,442,0.098328416912488
وصنعت,2017-09-23,440917988,27,11,0,8,0,430510,0,430510,0,440917988,0,440917988,0,447,444,446,445,430510,443,0.098231827111984
وصنعت,2017-09-24,343675246,31,10,0,19,0,335051,0,335051,0,343675246,0,343675246,0,450,444,444,447,335051,443,0.098135426889107
وصنعت,2017-09-25,78178690,11,4,1,7,0,72742,2500,75242,0,75568690,2610000,78178690,0,454,444,444,454,75242,444,0.098039215686275
وصنعت,2017-09-26,150330116,22,8,0,8,1,146505,0,131440,15065,150330116,0,134963816,15366300,447,443,446,444,146505,444,0
وصنعت,2017-09-27,696665751,31,13,1,6,1,671352,10000,91352,590000,686336111,10329640,93830782,602834969,449,441,446,443,681352,444,0.09794319294809
وصنعت,2017-10-02,246317000,17,7,0,8,0,241500,0,241500,0,246317000,0,246317000,0,444,441,443,441,241500,444,0
وصنعت,2017-10-03,336358115,35,12,0,18,0,330311,0,330311,0,336358115,0,336358115,0,450,441,442,443,330311,444,-0.097847358121331
وصنعت,2017-10-04,286748092,16,10,0,9,0,281400,0,281400,0,286748092,0,286748092,0,447,442,442,447,281400,444,0
وصنعت,2017-10-07,347112905,32,14,1,10,0,241966,100000,341966,0,245612905,101500000,347112905,0,441,439,441,439,341966,443,-0.09794319294809
وصنعت,2017-10-08,1823733417,105,12,1,23,0,433729,1370214,1803943,0,436490536,1387242881,1823733417,0,447,435,441,439,1803943,439,-0.882352941176471
وصنعت,2017-10-09,149359052,15,7,1,12,0,28671,118602,147273,0,29071032,120288020,149359052,0,445,439,441,441,147273,439,0
وصنعت,2017-10-10,754109831,43,4,1,17,1,30014,707224,637238,100000,30389695,723720136,652559831,101550000,448,439,441,441,737238,441,0.494559841740851
وصنعت,2017-10-11,804934679,31,6,1,15,0,46950,738109,785059,0,47710750,757223929,804934679,0,447,441,441,441,785059,443,0.393700787401575
وصنعت,2017-10-14,67228936,15,8,1,6,1,30744,35000,30744,35000,31213936,36015000,31213936,36015000,447,440,441,447,65744,443,0
وصنعت,2017-10-15,693979595,33,5,1,5,2,25184,648499,463683,210000,25550627,668428968,477679595,216300000,449,439,440,447,673683,445,0.392156862745098
وصنعت,2017-10-16,83421570,19,10,0,5,0,82379,0,82379,0,83421570,0,83421570,0,447,439,439,441,82379,444,-0.09765625
وصنعت,2017-10-17,2350749846,45,10,2,7,2,89230,2229139,37822,2280547,90440244,2260309602,38380956,2312368890,443,439,441,439,2318369,440,-0.879765395894428
وصنعت,2017-10-18,2769384456,220,45,2,12,1,1276012,1488160,489447,2274725,1279266406,1490118050,491598226,2277786230,439,434,439,434,2764172,435,-1.18343195266272
وصنعت,2017-10-21,1965921956,121,46,1,9,1,807007,1162634,330236,1639405,798748770,1167173186,333549553,1632372403,447,419,439,419,1969641,434,-0.399201596806387
وصنعت,2017-10-22,343607979,41,9,2,15,0,98752,243717,342469,0,98865225,244742754,343607979,0,444,434,435,443,342469,434,0.100200400801603
وصنعت,2017-10-23,113069788,10,6,1,4,0,97327,15450,112777,0,97434838,15634950,113069788,0,441,432,441,439,112777,434,0
وصنعت,2017-10-24,513354573,77,19,2,12,0,153197,360000,513197,0,153286789,360067784,513354573,0,439,434,439,437,513197,434,0
وصنعت,2017-10-25,1600966985,115,6,3,38,2,46845,1520574,1551419,16000,47238815,1553728170,1584561985,16405000,447,434,435,443,1567419,443,2.002002002002
وصنعت,2017-10-28,1135269428,45,10,1,14,1,105620,1014128,876346,243402,106570645,1028698783,887242790,248026638,445,437,443,445,1119748,441,-0.294406280667321
وصنعت,2017-10-29,288419649,33,14,1,13,0,145124,138847,283971,0,145894260,142525389,288419649,0,446,435,437,446,283971,441,0
وصنعت,2017-10-30,139485080,24,5,1,12,0,52500,83768,136268,0,53752500,85732580,139485080,0,446,439,446,445,136268,442,0.098425196850394
وصنعت,2017-10-31,649557859,41,15,1,12,0,128736,507707,636443,0,130235904,519321955,649557859,0,446,437,446,446,636443,442,0.098328416912488
وصنعت,2017-11-01,247170684,17,8,1,6,0,87633,154875,242508,0,89146934,158023750,247170684,0,446,439,446,439,242508,442,0
وصنعت,2017-11-04,300983715,34,7,1,12,1,42200,254649,112849,184000,42558500,258425215,114220410,186763305,444,437,440,437,296849,442,-0.098231827111984
وصنعت,2017-11-05,182770320,24,6,2,13,0,157687,22295,179982,0,160159830,22610490,182770320,0,444,439,439,441,179982,442,0
وصنعت,2017-11-06,212741814,23,4,2,12,1,154479,55495,109974,100000,156058074,56683740,111721814,101020000,445,439,443,440,209974,442,0
وصنعت,2017-11-07,82431000,17,4,1,11,0,10666,70000,80666,0,10866820,71564180,82431000,0,445,440,443,444,80666,442,0
وصنعت,2017-11-08,155173238,9,1,2,7,1,2000,150159,132159,20000,2030000,153143238,134773238,20400000,444,439,439,443,152159,442,0
وصنعت,2017-11-11,54831693,14,5,2,7,0,9863,44050,53913,0,9982143,44849550,54831693,0,444,439,440,440,53913,442,0
وصنعت,2017-11-12,104731154,24,10,2,11,0,53014,50000,103014,0,53872154,50859000,104731154,0,444,439,444,440,103014,442,0
وصنعت,2017-11-13,401874938,30,14,3,10,1,198300,197000,195300,200000,201003938,200871000,197874938,204000000,445,439,440,439,395300,442,0
وصنعت,2017-11-14,611998690,30,10,3,6,4,264648,338667,77931,525384,268304956,343693734,79445424,532553266,444,439,443,442,603315,441,-0.098328416912488
وصنعت,2017-11-15,191784033,12,1,3,6,1,1003,187000,79003,109000,1014033,190770000,80604033,111180000,444,439,439,443,188003,441,0
وصنعت,2017-11-18,202819214,27,11,3,9,1,68480,130771,93251,106000,69532794,133286420,94699214,108120000,443,439,443,439,199251,441,0
وصنعت,2017-11-20,258801101,24,8,3,2,2,173980,83020,30000,227000,175228501,83572600,30314000,228487101,443,437,440,442,257000,441,-0.098425196850394
وصنعت,2017-11-21,1204275588,91,15,3,12,3,408918,785423,364295,830046,410157016,794118572,367774555,836501033,443,434,439,434,1194341,439,-0.394088669950739
وصنعت,2017-11-22,2105643380,178,34,3,11,4,707162,1390085,1184421,912826,707413600,1398229780,1188402673,917240707,442,433,439,433,2097247,436,-0.692383778437191
وصنعت,2017-11-25,3518390752,301,53,3,11,1,2621990,889553,3411544,99999,2625238949,893151803,3417391762,100998990,439,431,438,438,3511543,435,-0.199203187250996
وصنعت,2017-11-26,845619290,82,9,2,10,3,422165,419630,116795,725000,424657250,420962040,117939790,727679500,441,434,439,440,841795,436,0.099800399201597
وصنعت,2017-11-28,881925237,48,16,2,14,2,862643,6000,570373,298270,875843237,6082000,578882917,303042320,443,438,441,441,868643,438,0.598205383848455
وصنعت,2017-11-29,730165155,46,8,1,18,1,689681,30000,619681,100000,699789155,30376000,628665155,101500000,442,439,442,441,719681,439,0.198216055500496
وصنعت,2017-12-02,57851155,17,6,1,13,0,47965,8787,56752,0,48888415,8962740,57851155,0,445,439,439,445,56752,439,0
وصنعت,2017-12-03,296621339,25,8,1,14,1,284466,5500,217628,72338,290994839,5626500,222891639,73729700,447,442,444,442,289966,440,0.19782393669634
وصنعت,2017-12-04,67745610,15,6,1,11,0,55470,11000,66470,0,56525610,11220000,67745610,0,446,439,439,442,66470,440,0
وصنعت,2017-12-05,58307203,15,8,1,7,0,47329,10000,57329,0,48070203,10237000,58307203,0,445,440,445,445,57329,440,0
وصنعت,2017-12-09,2867935392,183,12,3,42,2,1117280,1656301,2366689,406892,1162170836,1705764556,2442825212,425110180,456,442,442,456,2773581,449,2.07305034550839
وصنعت,2017-12-10,910640953,134,25,1,38,1,610804,252066,549644,313226,645197553,265443400,579208167,331432786,461,452,456,461,862870,454,0.967117988394584
وصنعت,2017-12-11,4069974422,201,41,5,31,2,3139757,665606,2755363,1050000,3358437222,711537200,2950533792,1119440630,468,460,460,465,3805363,465,2.4904214559387
وصنعت,2017-12-12,2513261331,150,37,2,40,2,1892475,426911,2258273,61113,2049132467,464128864,2446147918,67113413,481,464,467,478,2319386,471,1.30841121495327
وصنعت,2017-12-13,2514883031,174,60,2,31,2,1727462,600000,1977462,350000,1863481215,651401816,2139683031,375200000,481,465,480,478,2327462,470,-0.276752767527675
وصنعت,2017-12-16,1884284213,143,46,3,33,1,1390448,323200,813648,900000,1529121583,355162630,898349725,985934488,487,472,486,478,1713648,477,1.66512488436633
وصنعت,2017-12-17,3107760846,158,46,2,56,1,2334293,424844,2659137,100000,2625827140,481933706,2994660846,113100000,495,479,479,495,2759137,489,2.45677888989991
وصنعت,2017-12-18,1572777400,125,28,3,43,2,1053085,330838,1218923,165000,1196164884,376612516,1384512400,188265000,498,489,489,496,1383923,493,0.710479573712256
وصنعت,2017-12-19,552736516,51,18,2,22,1,252607,233460,386067,100000,285142536,267593980,438136516,114600000,500,487,493,490,486067,493,0.088183421516755
وصنعت,2017-12-20,928922234,86,17,3,39,3,233750,571963,600713,205000,265088020,663834214,691780734,237141500,510,487,487,497,805713,497,0.704845814977974
وصنعت,2017-12-23,632642598,39,17,3,15,1,178816,366185,445001,100000,205705426,426937172,516642598,116000000,509,497,509,499,545001,499,0.437445319335083
وصنعت,2017-12-24,2023822120,92,20,3,17,3,559132,1224446,518578,1265000,629940418,1393881702,594195066,1429627054,504,487,499,495,1783578,493,-1.13240418118467
وصنعت,2017-12-25,384688978,42,13,2,20,1,178272,161507,325919,13860,201360760,183328218,369098978,15590000,497,488,493,497,339779,493,-0.088105726872247
وصنعت,2017-12-26,1015414118,60,10,1,33,1,609112,272614,851726,30000,702354862,313059256,981214118,34200000,504,489,489,504,881726,497,0.793650793650794
وصنعت,2017-12-27,1401167743,81,6,1,35,5,677508,514218,828370,363356,795212256,605955487,974784635,426383108,513,500,506,513,1191726,506,1.92475940507437
وصنعت,2017-12-30,1308024758,61,12,2,20,1,696099,455997,972262,179834,786866181,521158577,1102654330,205370428,504,484,500,492,1152096,498,-1.63090128755365
وصنعت,2017-12-31,3022946670,147,22,3,40,0,1215468,1518495,2733963,0,1342394859,1680551811,3022946670,0,500,473,500,483,2733963,480,-3.49040139616056
وصنعت,2018-01-01,1585132539,86,15,2,25,3,1116728,275483,823391,568820,1270729296,314403243,936137739,648994800,499,474,474,495,1392211,491,2.26039783001808
وصنعت,2018-01-02,455778548,23,6,1,13,1,141700,260445,360065,42080,158876200,296902348,407724988,48053560,498,482,488,487,402145,492,0.08841732979664
وصنعت,2018-01-03,314008632,55,11,4,12,0,121724,162926,284650,0,134198656,179809976,314008632,0,494,472,487,475,284650,490,-0.441696113074205
وصنعت,2018-01-06,653037747,61,11,2,16,1,527459,55000,562459,20000,591662747,61375000,630357747,22680000,494,482,487,494,582459,489,-0.177462289263532
وصنعت,2018-01-07,541512243,42,11,1,9,2,472627,3000,323164,152463,538152243,3360000,367779046,173733197,499,487,487,494,475627,490,0.355555555555556
وصنعت,2018-01-08,537692745,25,11,2,4,3,459188,20000,120188,359000,515227745,22465000,134892786,402799959,491,487,487,487,479188,490,-0.177147918511957
وصنعت,2018-01-09,159424715,23,4,2,8,0,123617,17615,141232,0,139711145,19713570,159424715,0,492,486,487,492,141232,490,0
وصنعت,2018-01-10,1499158352,66,10,1,17,3,1236948,88600,487738,837810,1399089502,100068850,551856992,947301360,494,487,488,493,1325548,491,0.266193433895297
وصنعت,2018-01-13,670556122,36,8,2,11,2,330390,257800,222000,366190,375476442,295079680,253842680,416713442,499,491,493,491,588190,492,0.265486725663717
وصنعت,2018-01-14,394048403,28,7,2,5,2,241462,106249,137711,210000,272996898,121051505,156054003,237994400,498,489,497,491,347711,492,0
وصنعت,2018-01-15,920414819,49,12,4,11,4,303887,513000,98295,718592,342426369,577988450,110514297,809900522,494,486,489,491,816887,491,-0.264783759929391
وصنعت,2018-01-16,385174384,29,12,3,9,0,164942,179058,344000,0,184746040,200428344,385174384,0,489,486,489,487,344000,490,-0.176991150442478
وصنعت,2018-01-17,1151884956,68,13,4,15,2,775842,247196,528838,494200,875035168,276849788,593558956,558326000,491,483,487,491,1023038,490,-0.088652482269504
وصنعت,2018-01-20,828280015,62,21,1,11,2,568803,157892,406570,320125,648341027,179938988,463108630,365171385,499,492,495,496,726695,492,0.443655723158829
وصنعت,2018-01-21,622317673,45,14,2,15,1,159063,391050,450113,100000,179857753,442459920,509217673,113100000,495,487,491,492,550113,492,0
وصنعت,2018-01-22,404602850,28,9,1,8,1,306385,53018,358403,1000,344891510,59711340,403472850,1130000,492,487,491,491,359403,491,-0.088339222614841
وصنعت,2018-01-23,3640388094,149,27,4,10,2,1596300,1639982,452282,2784000,1797832112,1842555982,513151806,3127236288,495,487,493,493,3236282,489,-0.530503978779841
وصنعت,2018-01-24,11211866913,510,59,7,97,10,6683911,2940621,5338580,4285952,7770674612,3441192301,6227203104,4984663809,518,487,489,518,9624532,506,3.55555555555556
وصنعت,2018-01-27,20741269737,564,100,3,57,9,16069503,896000,4092479,12873024,19645461737,1095808000,5000136626,15741133111,531,517,522,531,16965503,531,4.97854077253219
وصنعت,2018-01-28,32762308776,1127,215,7,188,9,22017450,3623475,13368840,12272085,28138188023,4624120753,17026547865,15735760911,558,539,554,558,25640925,555,4.4971381847915
وصنعت,2018-01-29,8799777365,431,79,4,130,5,5487060,1323000,5973395,836665,7086003252,1713774113,7721518815,1078258550,571,544,565,568,6810060,561,1.09546165884194
وصنعت,2018-01-30,3499797185,182,58,3,59,4,2275577,419424,2461128,233873,2961971717,537825468,3197164960,302632225,581,555,581,560,2695001,564,0.541795665634675
وصنعت,2018-01-31,5790993374,296,72,3,57,4,3531789,1122800,2794462,1860127,4394503374,1396490000,3476074552,2314918822,560,536,560,545,4654589,540,-4.23402617397998
وصنعت,2018-02-04,15194126597,507,90,2,104,6,8605361,3069260,8121298,3553323,11185875335,4008251262,10551358377,4642768220,575,543,547,573,11674621,565,4.58199356913183
وصنعت,2018-02-05,12809663041,494,117,5,92,7,6018682,3710491,7330419,2398754,7922439252,4887223789,9629502663,3180160378,586,556,580,564,9729173,572,1.22982321291314
وصنعت,2018-02-06,3717016072,184,39,4,75,0,1292411,1600384,2892795,0,1658878220,2058137852,3717016072,0,568,556,567,558,2892795,558,-2.42976461655277
وصنعت,2018-02-07,2315701190,117,39,1,32,5,1759181,30000,651456,1137725,2277021070,38680120,843916941,1471784249,573,560,562,564,1789181,562,0.700389105058366
وصنعت,2018-02-10,2266985894,133,40,1,26,1,1727523,50223,617746,1160000,2202700224,64285670,789378551,1477607343,563,548,563,556,1777746,554,-1.46831530139104
وصنعت,2018-02-12,1576359026,85,40,2,22,0,1017140,227870,1245010,0,1290371526,285987500,1576359026,0,571,543,571,543,1245010,551,-0.470588235294118
وصنعت,2018-02-13,32480392613,1039,220,7,153,11,18831811,5642474,10893409,13580876,24980796752,7499595861,14395444885,18084947728,579,546,563,569,24474285,576,4.57052797478329
وصنعت,2018-02-14,11873123605,390,78,2,106,3,8386305,623000,8053075,956230,11046639161,826484444,10604546473,1268577132,579,558,576,560,9009305,573,-0.678221552373775
وصنعت,2018-02-17,10036304978,517,133,4,50,2,5317788,2667000,2808894,5175894,6687393893,3348911085,3546282216,6490022762,572,544,572,544,7984788,546,-4.62822458270106
وصنعت,2018-02-18,1507866982,124,61,0,31,2,1222399,0,1134199,88200,1507866982,0,1398855358,109011624,550,535,543,536,1222399,539,-1.27287191726333
وصنعت,2018-02-19,5981011904,256,77,4,28,3,4084507,852302,1049159,3887650,4955383686,1025628218,1273371123,4707640781,547,521,543,521,4936809,526,-2.33682514101531
وصنعت,2018-02-21,2346432416,175,45,3,31,4,1606395,343650,950512,999533,1935807492,410624924,1143220102,1203212314,534,518,519,526,1950045,523,-0.742574257425743
وصنعت,2018-02-26,2579264368,143,49,3,28,1,1308540,830000,634356,1504184,1577564368,1001700000,765459918,1813804450,543,520,543,521,2138540,524,0.249376558603491
وصنعت,2018-02-27,3493555467,157,30,2,32,4,874365,2039774,762966,2151173,1048143971,2445411496,914324086,2579231381,521,518,521,521,2914139,521,-0.580431177446103
وصنعت,2018-02-28,2267241280,137,39,2,32,2,1529002,373408,1000210,902200,1821385536,445855744,1192552355,1074688925,525,516,519,521,1902410,518,-0.583819849874896
وصنعت,2018-03-03,3078087928,139,33,4,35,1,2014870,601867,2603537,13200,2370313782,707774146,3062460728,15627200,520,506,516,515,2616737,511,-1.34228187919463
وصنعت,2018-03-04,1770080830,125,21,0,34,2,1477653,0,535677,941976,1770080830,0,640073696,1130007134,521,513,519,521,1477653,519,1.53061224489796
وصنعت,2018-03-05,1147389173,118,41,2,23,2,755514,201000,601514,355000,906835560,240553613,721192306,426196867,526,518,525,518,956514,520,0.251256281407035
وصنعت,2018-03-06,871786458,69,23,1,23,1,679094,50000,640083,89011,811836958,59949500,764973258,106813200,521,515,518,519,729094,520,-0.083542188805347
وصنعت,2018-03-07,739715671,100,29,5,40,0,401664,220000,621664,0,477461757,262253914,739715671,0,524,514,516,520,621664,519,-0.167224080267559
وصنعت,2018-03-10,1954206278,151,40,1,37,1,1349811,300000,1399811,250000,1598256110,355950168,1658658753,295547525,520,512,514,518,1649811,515,-0.753768844221106
وصنعت,2018-03-11,918665870,70,25,0,30,1,773322,0,753322,20000,918665870,0,894825870,23840000,519,513,515,517,773322,515,0.084388185654009
وصنعت,2018-03-12,5677674143,257,76,4,32,2,4762852,34000,2305809,2491043,5637382143,40292000,2733863053,2943811090,523,512,515,515,4796852,514,-0.168634064080944
وصنعت,2018-03-25,353175728,48,16,2,18,1,297084,53000,250084,100000,300171128,53004600,252075728,101100000,533,522,523,528,350084,527,2.54065040650406
وصنعت,2018-03-26,297459098,25,12,0,8,0,294602,0,294602,0,297459098,0,297459098,0,533,524,524,531,294602,527,0
وصنعت,2018-03-27,307824295,25,12,0,10,0,306633,0,306633,0,307824295,0,307824295,0,530,523,525,530,306633,527,-0.099108027750248
وصنعت,2018-03-28,427275847,52,19,0,13,1,423314,0,113414,309900,427275847,0,114430178,312845669,532,525,532,528,423314,527,0
وصنعت,2018-04-03,469897279,51,22,1,15,0,459202,8800,468002,0,461075879,8821400,469897279,0,528,524,525,524,468002,526,-0.099206349206349
وصنعت,2018-04-04,2692757721,171,24,3,20,2,2611109,78200,905903,1783406,2614230372,78527349,906363763,1786393958,526,523,524,523,2689309,523,-0.595829195630586
وصنعت,2018-04-07,1698071637,94,20,4,28,2,330123,1369367,1443072,256418,329360659,1368710978,1441653637,256418000,523,515,522,523,1699490,522,-0.1998001998002
وصنعت,2018-04-08,946636840,88,24,0,20,0,970926,0,970926,0,946636840,0,946636840,0,520,505,520,510,970926,515,-1.3013013013013
وصنعت,2018-04-09,1152438296,111,49,2,22,1,1177791,30000,1095291,112500,1124058296,28380000,1046654976,105783320,508,490,506,502,1207791,504,-2.12981744421907
وصنعت,2018-04-10,501186100,47,14,0,14,0,518478,0,518478,0,501186100,0,501186100,0,515,502,515,507,518478,504,0
وصنعت,2018-04-11,721802050,57,22,0,17,0,759009,0,759009,0,721802050,0,721802050,0,506,493,505,493,759009,501,-0.621761658031088
وصنعت,2018-04-15,430246204,57,24,1,12,0,428815,29610,458425,0,402393584,27852620,430246204,0,496,489,496,489,458425,499,-0.521376433785193
وصنعت,2018-04-16,682980303,56,30,2,10,0,691688,51650,743338,0,635863753,47116550,682980303,0,491,474,491,486,743338,491,-1.57232704402516
وصنعت,2018-04-17,268488141,52,23,1,16,0,278943,10000,288943,0,259318141,9170000,268488141,0,492,479,479,490,288943,490,-0.212992545260916
وصنعت,2018-04-18,352800785,34,16,1,15,0,324256,50000,374256,0,305790785,47010000,352800785,0,499,490,499,493,374256,490,0.106723585912487
وصنعت,2018-04-22,3028676642,214,85,1,43,3,3017938,34070,2602008,450000,2995228042,33448600,2583302521,445374121,533,512,520,513,3052008,519,0.915564598168871
وصنعت,2018-04-23,374927509,44,21,1,10,2,370579,9400,140142,239837,365612109,9315400,138616740,236310769,522,512,518,516,379979,518,-0.100806451612903
وصنعت,2018-04-24,617374478,47,22,1,9,2,620599,10000,270599,360000,607674478,9700000,265056499,352317979,516,507,507,515,630599,516,-0.403632694248234
وصنعت,2018-04-25,386117868,67,39,1,11,1,386506,10000,66258,330248,376407868,9710000,64485612,321632256,519,504,519,505,396506,514,-0.303951367781155
وصنعت,2018-04-28,1594397637,165,49,1,20,1,1647865,40055,1418168,269752,1556394562,38003075,1340530567,253867070,507,489,507,494,1687920,495,-3.76016260162602
وصنعت,2018-04-29,1514396552,108,46,2,16,0,1594738,60000,1654738,0,1458202552,56194000,1514396552,0,492,470,492,490,1654738,480,-3.0623020063358
وصنعت,2018-04-30,154703355,28,13,1,14,0,126488,40000,166488,0,117783355,36920000,154703355,0,493,476,476,482,166488,480,0.108932461873638
وصنعت,2018-05-01,318595146,31,19,1,11,0,311971,32500,344471,0,288500146,30095000,318595146,0,487,477,486,481,344471,481,0.108813928182807
وصنعت,2018-05-05,445213380,63,27,1,16,0,452097,34429,486526,0,413814132,31399248,445213380,0,485,475,481,476,486526,480,-0.108695652173913
وصنعت,2018-05-06,117248696,11,9,0,8,0,128480,0,128480,0,117248696,0,117248696,0,485,472,472,485,128480,480,0
وصنعت,2018-05-07,447931180,66,33,5,15,0,393317,98403,491720,0,356781468,91149712,447931180,0,491,470,488,481,491720,479,-0.217627856365615
وصنعت,2018-05-08,459995719,60,20,1,25,0,481156,10000,491156,0,450608019,9387700,459995719,0,491,486,490,490,491156,482,0.54525627044711
وصنعت,2018-05-09,1217574794,93,34,2,13,1,1217026,125000,1129755,212271,1104054794,113520000,1025522394,192052400,481,470,470,476,1342026,476,-1.19305856832972
وصنعت,2018-05-12,144129033,23,10,0,9,1,157045,0,111045,46000,144129033,0,101809033,42320000,481,476,476,479,157045,477,0.109769484083425
وصنعت,2018-05-13,462918841,48,21,1,16,0,400075,100000,500075,0,370918841,92000000,462918841,0,490,479,486,489,500075,479,0.43859649122807
وصنعت,2018-05-14,1112272073,78,21,0,34,3,1167620,0,1051557,116063,1112272073,0,1002252538,110019535,502,487,490,502,1167620,491,2.62008733624454
وصنعت,2018-05-15,956787702,84,27,0,34,2,980127,0,930127,50000,956787702,0,907817702,48970000,516,504,504,511,980127,502,2.12765957446808
وصنعت,2018-05-16,400729769,50,14,0,30,1,407278,0,386532,20746,400729769,0,380253467,20476302,519,493,493,513,407278,504,0.520833333333333
وصنعت,2018-05-19,741974881,56,11,0,20,2,756603,0,738603,18000,741974881,0,724187881,17787000,517,505,516,509,756603,508,0.725388601036269
وصنعت,2018-05-20,414019842,55,20,1,13,1,404775,22000,359755,67020,392723842,21296000,348763322,65256520,512,503,508,510,426775,508,0
وصنعت,2018-05-21,398144469,45,14,1,16,2,408852,800,379652,30000,397386069,758400,368764469,29380000,512,496,499,512,409652,508,0
وصنعت,2018-05-22,221292247,91,18,0,8,0,232511,0,232511,0,221292247,0,221292247,0,507,495,497,496,232511,506,-0.308641975308642
وصنعت,2018-05-23,149797457,19,16,0,7,0,157761,0,157761,0,149797457,0,149797457,0,505,496,505,497,157761,505,-0.206398348813209
وصنعت,2018-05-26,539517732,62,28,2,23,0,475757,90000,565757,0,453949208,85568524,539517732,0,506,491,491,497,565757,503,-0.413650465356773
وصنعت,2018-05-27,1093365795,94,31,4,22,1,698471,444261,1132732,10000,661584508,431781287,1083565795,9800000,512,491,492,512,1142732,501,-0.415368639667705
وصنعت,2018-05-28,92843573,18,7,1,10,0,47910,49953,97863,0,45550694,47292879,92843573,0,506,493,493,502,97863,501,-0.104275286757039
وصنعت,2018-05-29,371203124,52,21,2,12,0,352946,40909,393855,0,332718664,38484460,371203124,0,494,491,494,492,393855,499,-0.313152400835073
وصنعت,2018-05-30,266390793,30,19,1,12,0,231640,50000,281640,0,219040793,47350000,266390793,0,499,491,493,491,281640,499,-0.104712041884817
وصنعت,2018-06-02,679434933,95,48,1,14,1,678662,50000,328662,400000,632684933,46750000,306469657,372965276,497,483,491,489,728662,494,-0.943396226415094
وصنعت,2018-06-03,1191424847,93,38,3,15,1,1029558,250000,344874,934684,958097818,233327029,321305208,870119639,489,485,487,486,1279558,489,-1.05820105820106
وصنعت,2018-06-09,340330440,42,14,1,17,1,288069,74449,361362,1156,270490517,69839923,339236864,1093576,494,489,491,490,362518,489,0.106951871657754
وصنعت,2018-06-10,1069742384,75,20,1,13,1,1068493,74627,817540,325580,999758377,69984007,765401356,304341028,492,486,492,489,1143120,489,0
وصنعت,2018-06-11,930011413,69,29,1,13,0,985906,15000,1000906,0,915986413,14025000,930011413,0,491,483,487,489,1000906,487,-0.427350427350427
وصنعت,2018-06-12,478416270,57,23,1,20,3,446126,64246,420724,89648,418325517,60090753,393928558,84487712,493,483,489,488,510372,488,0.214592274678112
وصنعت,2018-06-13,3366444435,250,63,0,39,6,3467741,0,3169116,298625,3366444435,0,3076848705,289595730,512,493,493,512,3467741,508,3.96145610278373
وصنعت,2018-06-17,2989352560,192,58,0,44,2,2946244,0,2886244,60000,2989352560,0,2929182560,60170000,533,519,519,533,2946244,531,4.53141091658084
وصنعت,2018-06-18,4634425300,304,83,0,90,3,4393221,0,3373194,1020027,4634425300,0,3548496950,1085928350,557,538,549,544,4393221,551,3.94088669950739
وصنعت,2018-06-19,6737942087,385,58,3,106,4,5725832,488777,5119609,1095000,6207047948,530894139,5547682287,1190259800,579,539,549,579,6214609,567,2.74881516587678
وصنعت,2018-06-20,1742971710,75,14,0,23,1,1540295,0,1440295,100000,1742971710,0,1631071710,111900000,595,578,578,595,1540295,588,3.78228782287823
وصنعت,2018-06-23,4241180183,273,100,1,44,2,3600299,160000,3150978,609321,4061806339,179373844,3552791666,688388517,601,575,596,590,3760299,590,0.266666666666667
وصنعت,2018-06-24,10352473785,427,115,2,85,6,8260337,500000,7036483,1723854,9761135815,591337970,8311670649,2040803136,619,582,606,619,8760337,618,4.78723404255319
وصنعت,2018-06-25,11709722751,579,176,2,132,7,9022432,600000,7331270,2291162,10969222751,740500000,8876783670,2832939081,649,609,646,619,9622432,636,2.96108291032149
وصنعت,2018-06-26,2692748963,132,51,1,35,0,1326450,1000000,2326450,0,1535748963,1157000000,2692748963,0,631,605,631,605,2326450,605,-4.93015612161052
وصنعت,2018-06-27,7184440817,368,117,0,80,1,6476313,0,6471991,4322,7184440817,0,7179613167,4827650,610,575,575,580,6476313,580,-4.14866032843561
وصنعت,2018-06-30,980849729,73,19,1,28,1,775037,100000,865037,10000,867318129,113531600,969599729,11250000,595,561,561,582,875037,583,0.541027953110911
وصنعت,2018-07-01,2166334078,247,63,2,32,1,1717711,300000,2012711,5000,1830803608,335530470,2161025078,5309000,596,554,596,554,2017711,561,-3.67713004484305
وصنعت,2018-07-02,2135302140,124,37,4,47,3,1128551,817245,1295551,650245,1232997274,902304866,1420463354,714838786,587,554,561,574,1945796,573,2.1415270018622
وصنعت,2018-07-03,723058125,82,27,0,32,2,644652,0,425522,219130,723058125,0,477487620,245570505,595,575,582,588,644652,578,0.820419325432999
وصنعت,2018-07-04,2337201029,118,46,1,28,2,2103458,17678,648483,1472653,2317825941,19375088,715707159,1621493870,589,570,582,574,2121136,576,-0.361663652802893
وصنعت,2018-07-07,1161060336,101,38,1,28,1,991149,54941,1036090,10000,1100805354,60254982,1149910336,11150000,590,557,557,566,1046090,579,0.453720508166969
وصنعت,2018-07-08,429926356,50,27,0,21,0,394851,0,394851,0,429926356,0,429926356,0,580,560,580,562,394851,577,-0.3613369467028
وصنعت,2018-07-10,239303339,56,21,0,33,0,222345,0,222345,0,239303339,0,239303339,0,570,556,556,569,222345,575,-0.271985494106981
وصنعت,2018-07-11,1051644036,126,52,1,44,1,924196,70940,787136,208000,976651396,74992640,834048036,217596000,565,546,562,554,995136,562,-2.18181818181818
وصنعت,2018-07-14,659145502,74,33,2,15,2,486242,138570,272292,352520,513183348,145962154,286989523,372155979,561,549,561,552,624812,559,-0.650557620817844
وصنعت,2018-07-15,780214196,79,23,2,20,1,576852,169175,520024,226003,603197971,177016225,544204939,236009257,559,544,546,544,746027,554,-0.935453695042095
وصنعت,2018-07-16,806145875,115,40,1,32,1,710938,62600,546473,227065,741060075,65085800,571040276,235105599,553,538,546,538,773538,550,-0.661000944287063
وصنعت,2018-07-17,1990526461,181,53,2,17,3,1775259,160479,942938,992800,1825303570,165222891,969802861,1020723600,547,536,539,536,1935738,537,-2.28136882129278
وصنعت,2018-07-18,610343718,65,23,1,20,0,543796,50000,593796,0,559043718,51300000,610343718,0,544,535,536,543,593796,537,0
وصنعت,2018-07-21,259995020,38,18,1,14,0,241971,10000,251971,0,249745020,10250000,259995020,0,543,535,536,543,251971,538,0.09727626459144
وصنعت,2018-07-22,576565213,67,37,1,22,3,548141,2000,367690,182451,574455213,2110000,384908580,191656633,554,540,544,550,550141,541,0.583090379008746
وصنعت,2018-07-23,1200084371,114,54,1,21,1,1118749,40000,521237,637512,1158854371,41230000,538068737,662015634,554,536,549,546,1158749,541,0
وصنعت,2018-07-24,1206846964,115,45,1,19,2,1087818,72289,856094,304013,1132067849,74779115,889690239,317156725,553,538,546,538,1160107,543,0.289855072463768
وصنعت,2018-07-25,1908976316,108,38,1,13,2,1826193,30000,588658,1267535,1878236316,30740000,605665850,1303310466,549,535,536,541,1856193,537,-0.963391136801541
وصنعت,2018-07-28,3958499447,254,87,0,48,7,3731854,0,843637,2888217,3958499447,0,899845153,3058654294,564,547,554,558,3731854,555,3.21011673151751
وصنعت,2018-07-29,3989842811,235,87,1,60,6,3511639,150000,2012508,1649131,3824136896,165705915,2212976607,1776866204,582,558,565,565,3661639,570,2.73327049952875
وصنعت,2018-07-30,5053100733,273,81,3,47,4,4332347,285700,1552016,3066031,4739717733,313383000,1700228846,3352871887,580,566,571,569,4618047,572,0.36697247706422
وصنعت,2018-07-31,10501113328,580,169,3,98,5,8805289,411900,5149646,4067543,10037793413,463319915,5855726200,4645387128,600,575,575,600,9217189,595,4.11334552102377
وصنعت,2018-08-01,7486867229,492,142,5,104,4,5012648,1580136,3906710,2686074,5629479218,1857388011,4457799763,3029067466,625,570,605,575,6592784,594,-0.263388937664618
وصنعت,2018-08-08,1125012694,108,41,2,27,0,969746,60000,1029746,0,1059822694,65190000,1125012694,0,575,566,575,572,1029746,581,-2.20070422535211
وصنعت,2018-08-11,3525413538,282,77,2,90,3,2217667,1050000,2747667,520000,2372385119,1153028419,2953623538,571790000,593,552,584,565,3267667,564,-2.88028802880288
وصنعت,2018-08-12,2359086842,152,61,1,22,1,2145498,72000,1517498,700000,2282348842,76738000,1618700183,740386659,572,551,564,554,2217498,556,-1.39017608897127
وصنعت,2018-08-14,633497395,74,33,1,35,1,581928,10000,589031,2897,622867395,10630000,630406296,3091099,570,554,556,555,591928,557,0.188146754468485
وصنعت,2018-08-18,3796302822,201,85,4,28,4,3238210,360000,1129177,2469033,3415162822,381140000,1190441124,2605861698,562,547,550,549,3598210,551,0.189933523266857
وصنعت,2018-08-19,5904790021,332,105,2,37,3,5288843,320000,1441788,4167055,5568690021,336100000,1520435819,4384354202,562,548,562,550,5608843,550,-0.18957345971564
وصنعت,2018-08-20,12074124953,600,113,1,107,8,10805751,150000,3729485,7226266,11908717981,165406972,4097603109,7976521844,578,559,561,578,10955751,576,4.65337132003799
وصنعت,2018-08-21,4339543637,345,99,1,110,4,3807746,37000,3452656,392090,4298584637,40959000,3891919379,447624258,601,578,583,585,3844746,590,2.45009074410163
وصنعت,2018-08-25,5572759069,337,111,2,66,1,4717231,220000,4860231,77000,5325269069,247490000,5485930638,86828431,605,583,597,589,4937231,590,0
وصنعت,2018-08-26,17450650057,814,183,0,114,6,14903388,0,12532275,2371113,17450650057,0,14648621384,2802028673,619,592,598,617,14903388,612,3.72010628875111
وصنعت,2018-08-27,15258298313,666,159,2,164,4,11926634,660000,8235072,4351562,14456964941,801333372,9953506657,5304791656,639,619,619,637,12586634,633,3.50128095644748
وصنعت,2018-08-28,7181253005,357,138,2,64,2,4999713,1030000,4028435,2001278,5917513005,1263740000,4770610311,2410642694,649,605,643,616,6029713,623,-1.73267326732673
وصنعت,2018-08-29,11207907969,652,231,2,67,2,8762050,1030000,9617040,175010,10040687969,1167220000,11001121079,206786890,625,592,623,605,9792050,598,-3.86230058774139
وصنعت,2018-09-01,5473113782,330,123,2,80,2,4205051,510000,4293423,421628,4883663782,589450000,4979099452,494014330,620,595,620,596,4715051,607,1.39737991266376
وصنعت,2018-09-02,2508750176,220,88,2,48,1,1450090,760000,1950541,259549,1648872364,859877812,2211934385,296815791,607,588,606,588,2210090,593,-2.23944875107666
وصنعت,2018-09-03,4878702719,302,101,2,50,2,4289588,41100,3740188,590500,4832354219,46348500,4217906216,660796503,597,583,596,597,4330688,589,-0.704845814977974
وصنعت,2018-09-04,3877273644,298,120,1,56,1,3327839,43000,3040550,330289,3827694644,49579000,3497009516,380264128,605,596,605,600,3370839,601,2.04081632653061
وصنعت,2018-09-05,2766516233,229,85,1,61,1,2412656,20000,2302967,129689,2743716233,22800000,2618581706,147934527,605,591,605,594,2432656,594,-1.1304347826087
وصنعت,2018-09-08,9851116324,538,171,2,131,4,7775614,610000,6440368,1945246,9133108637,718007687,7565267905,2285848419,622,601,603,612,8385614,614,3.34212840809147
وصنعت,2018-09-09,13397325922,732,228,1,164,6,10730666,300000,5470138,5560528,13035525922,361800000,6664083543,6733242379,644,624,624,632,11030666,635,3.40425531914894
وصنعت,2018-09-10,12363543527,571,174,7,137,8,8302678,1410000,5803697,3908981,10566914515,1796629012,7381611167,4981932360,666,642,642,666,9712678,665,4.77366255144033
وصنعت,2018-09-11,16336416096,706,273,1,176,1,11812558,600000,12049781,362777,15534816096,801600000,15864743219,471672877,698,666,698,679,12412558,688,3.37784760408484
وصنعت,2018-09-12,3224889775,153,31,2,67,0,981107,1382024,2363131,0,1332329127,1892560648,3224889775,0,722,691,703,722,2363131,713,3.72340425531915
وصنعت,2018-09-15,5021065439,273,90,1,92,0,3582289,100000,3682289,0,4885465439,135600000,5021065439,0,746,709,746,709,3682289,713,-0.073260073260073
وصنعت,2018-09-16,16278438844,769,194,2,239,2,11860526,600000,11223303,1237223,15499565700,778873144,14659390510,1619048334,706,677,685,690,12460526,683,-4.25219941348974
وصنعت,2018-09-17,15552648245,707,178,2,190,6,10355124,1115364,10308890,1161598,14041300855,1511347390,13972157451,1580490794,717,687,687,705,11470488,709,3.82848392036753
وصنعت,2018-09-18,10897858696,480,132,2,129,4,7693928,210000,6575196,1328732,10615898696,281960000,9048674718,1849183978,732,695,726,723,7903928,721,1.69616519174041
وصنعت,2018-09-22,21044766973,669,254,1,137,7,14568504,5000,7857468,6716036,21037531973,7235000,11326662881,9718104092,756,727,734,756,14573504,755,4.713560551124
وصنعت,2018-09-23,15347248619,734,292,1,144,9,10131616,100000,8235015,1996601,15200248619,147000000,12364870057,2982378562,792,763,784,784,10231616,784,3.8781163434903
وصنعت,2018-09-24,51362482895,1454,357,5,170,10,28544628,4210000,8619628,24135000,44735295706,6627187189,13437596613,37924886282,823,784,784,823,32754628,820,4.53333333333333
وصنعت,2018-09-25,33727653722,1434,604,1,129,3,20674989,40000,11781096,8933893,33662953722,64700000,19246316241,14481337481,899,831,860,838,20714989,851,3.8265306122449
وصنعت,2018-09-26,46468496069,1784,648,1,259,5,28848001,10000,24074100,4783901,46452496069,16000000,38736740808,7731755261,861,831,861,842,28858001,842,-1.10565110565111
وصنعت,2018-09-29,59145560792,2127,558,1,281,8,35649066,10000,13747050,21912016,59129460792,16100000,22851392886,36294167906,883,842,858,883,35659066,867,3.04347826086957
وصنعت,2018-09-30,63979952110,2275,842,0,181,6,37040831,0,7632332,29408499,63979952110,0,13221844811,50758107299,910,889,910,905,37040831,903,4.09885473176612
وصنعت,2018-10-01,106996384581,2694,569,8,375,6,24808189,39725000,22604744,41928445,41583333591,65413050990,38062186989,68934197592,932,858,932,858,64533189,867,-3.99536768963521
وصنعت,2018-10-02,13595474271,506,157,2,163,0,3523972,5100000,8623972,0,5557874271,8037600000,13595474271,0,836,824,825,824,8623972,824,-4.94571773220748
وصنعت,2018-10-03,17396230380,815,250,2,301,2,10144858,1400000,10944858,600000,15295677944,2100552436,16493824529,902405851,804,783,783,792,11544858,788,-4.37817258883249
وصنعت,2018-10-06,28599151659,1016,263,3,249,5,11863183,7660000,16297329,3225854,17628231659,10970920000,23775520565,4823631094,813,748,787,748,19523183,766,-2.78699402786994
وصنعت,2018-10-07,26810509893,1139,170,3,339,1,6540383,12659522,18999905,200000,9182863620,17627646273,26527359893,283150000,758,728,728,728,19199905,730,-4.7098976109215
وصنعت,2018-10-08,12284857312,772,163,3,232,2,5760837,3231328,8872165,120000,7908290418,4376566894,12115137312,169720000,743,694,706,742,8992165,714,-2.14899713467049
وصنعت,2018-10-09,18206265058,746,288,2,122,3,12063511,695545,12159056,600000,17214051778,992213280,17345865058,860400000,750,726,742,732,12759056,746,4.46559297218155
وصنعت,2018-10-10,6743888086,419,123,5,121,4,3496932,1343800,4321663,519069,4849501169,1894386917,6028207394,715680692,758,712,758,718,4840732,728,-2.38262088297127
وصنعت,2018-10-13,18897242166,720,124,3,169,4,12129726,2100000,12341576,1888150,16116342166,2780900000,16387921731,2509320435,732,692,732,692,14229726,694,-4.66618808327351
وصنعت,2018-10-14,899438839,63,22,0,27,1,700729,0,393729,307000,899438839,0,507150959,392287880,688,665,665,679,700729,685,-1.35542168674699
وصنعت,2018-10-15,4785612883,205,64,0,78,5,3485362,0,1682723,1802639,4785612883,0,2307184258,2478428625,719,683,683,719,3485362,718,4.80916030534351
وصنعت,2018-10-16,5609848560,331,134,0,62,4,3974685,0,1925644,2049041,5609848560,0,2713729979,2896118581,753,722,732,732,3974685,738,2.76766205389658
وصنعت,2018-10-17,3982454610,223,86,1,78,1,2877811,10000,2428234,459577,3968444610,14010000,3340659598,641795012,736,706,732,728,2887811,721,-2.26789510985117
وصنعت,2018-10-20,7143346997,391,124,0,108,4,4946293,0,2556231,2390062,7143346997,0,3687353972,3455993025,756,727,727,756,4946293,755,4.713560551124
وصنعت,2018-10-21,5215753885,328,136,0,73,2,3685964,0,2063642,1622322,5215753885,0,2934060931,2281692954,773,724,773,732,3685964,740,-2.00831024930748
وصنعت,2018-10-22,7551912926,371,99,0,109,2,5374864,0,3678600,1696264,7551912926,0,5173674401,2378238525,756,721,729,756,5374864,734,-0.706713780918728
وصنعت,2018-10-23,5442828423,290,80,1,101,0,3871357,18393,3889750,0,5416986258,25842165,5442828423,0,752,726,752,730,3889750,731,-0.427046263345196
وصنعت,2018-10-24,6429459458,342,74,3,92,0,3298678,1410000,4708678,0,4486215729,1943243729,6429459458,0,736,705,719,725,4708678,713,-2.43030736240172
وصنعت,2018-10-27,16312525887,503,75,4,117,4,5789591,5883697,5621050,6052238,8079257262,8233268625,7841698213,8470827674,742,706,706,733,11673288,730,2.34432234432234
وصنعت,2018-10-28,9194719185,349,108,3,58,4,5354948,1200000,3546833,3008115,7513549185,1681170000,4980623677,4214095508,750,724,729,732,6554948,733,0.429491768074445
وصنعت,2018-10-29,19191838399,731,98,2,60,3,3555325,10010000,2631214,10934111,5057808399,14134030000,3735910305,15455928094,758,733,746,742,13565325,740,0.855310049893086
وصنعت,2018-10-31,4034933337,246,53,2,84,1,2148309,700000,2448309,400000,3049132059,985801278,3463733337,571200000,750,728,741,744,2848309,741,0.141342756183746
وصنعت,2018-11-03,7847164047,316,62,3,83,2,3582734,1976689,4471122,1088301,5058486690,2788677357,6304392150,1542771897,747,727,732,742,5559423,738,-0.352858151023289
وصنعت,2018-11-06,2252283156,122,21,2,60,1,1130225,443100,1568325,5000,1614177290,638105866,2245063156,7220000,758,732,747,755,1573325,747,1.20396600566572
وصنعت,2018-11-10,4198968785,270,40,2,87,1,1908211,1022026,2430237,500000,2733892986,1465075799,3480325944,718642841,755,738,747,752,2930237,749,0.279916025192442
وصنعت,2018-11-11,6337053591,353,42,3,128,1,3085551,1329342,4014893,400000,4434245696,1902807895,5766043591,571010000,761,742,747,753,4414893,750,0.139567341242149
وصنعت,2018-11-12,4133692302,221,54,2,74,2,2666602,210000,2056335,820267,3831565452,302126850,2954391425,1179300877,757,743,757,749,2876602,751,0.139372822299652
وصنعت,2018-11-13,5154369973,308,65,2,108,2,2581289,1037999,3394963,224325,3668908297,1485461676,4834468498,319901475,752,732,751,737,3619288,744,-0.904662491301322
وصنعت,2018-11-14,3821042796,219,40,3,88,1,687208,2030000,2217208,500000,960196764,2860846032,3111542796,709500000,745,724,744,736,2717208,735,-1.26404494382022
وصنعت,2018-11-17,4452261785,253,31,3,131,0,2093380,1105580,3198960,0,2911976201,1540285584,4452261785,0,732,721,729,727,3198960,728,-0.995732574679943
وصنعت,2018-11-18,4084712951,253,35,3,98,0,1446046,1494474,2940520,0,2013909035,2070803916,4084712951,0,742,718,732,723,2940520,726,-0.21551724137931
وصنعت,2018-11-19,3546688895,188,38,3,60,1,859231,1675213,2513128,21316,1202265899,2344422996,3516867811,29821084,734,726,731,730,2534444,731,0.719942404607631
وصنعت,2018-11-20,2646280480,158,34,2,57,1,608382,1295108,1603490,300000,843722605,1802557875,2226580480,419700000,732,718,722,731,1903490,727,-0.643316654753395
وصنعت,2018-11-21,4398829551,196,30,3,79,2,1335717,1787977,2135280,988414,1881411058,2517418493,3008743689,1390085862,742,732,732,734,3123694,736,1.29496402877698
وصنعت,2018-11-24,5098246545,276,84,2,65,0,2621582,1030000,3651582,0,3659150545,1439096000,5098246545,0,747,721,723,727,3651582,730,-0.852272727272727
وصنعت,2018-11-26,6076330262,349,70,2,96,0,2308156,2096436,4404592,0,3181753844,2894576418,6076330262,0,734,714,730,727,4404592,721,-1.14613180515759
وصنعت,2018-11-27,1668814611,190,58,2,37,0,1142011,63873,1205884,0,1580580771,88233840,1668814611,0,734,719,734,725,1205884,723,0.217391304347826
وصنعت,2018-11-28,1931444202,175,61,1,48,0,1363470,40000,1403470,0,1876664202,54780000,1931444202,0,731,716,731,721,1403470,720,-0.361532899493854
وصنعت,2018-12-01,7248810838,347,76,2,75,1,3187097,2200000,2418788,2968309,4296002197,2952808641,3266983572,3981827266,722,698,716,699,5387097,704,-2.322206095791
وصنعت,2018-12-02,7435100277,382,141,3,79,1,4028870,1501000,2014242,3515628,5423751277,2011349000,2712364705,4722735572,716,695,695,700,5529870,703,-0.074294205052006
وصنعت,2018-12-08,9955150283,529,198,3,71,4,6904992,1533900,5863679,2575213,8155237877,1799912406,6909990022,3045160261,769,730,763,738,8438892,744,5.82959641255605
وصنعت,2018-12-09,2789452535,230,72,2,58,2,1517674,880000,2021481,376193,1765627246,1023825289,2352492596,436959939,744,728,732,731,2397674,733,-1.44067796610169
وصنعت,2018-12-10,3090546812,222,56,1,43,0,2535441,100000,2635441,0,2974366812,116180000,3090546812,0,746,729,733,733,2635441,740,0.859845227858985
وصنعت,2018-12-11,2103553364,263,100,2,58,1,1684047,145000,1824047,5000,1933976045,169577319,2097703364,5850000,742,719,740,739,1829047,725,-1.96078431372549
وصنعت,2018-12-12,1210932322,169,66,2,44,0,849012,205962,1054974,0,974324640,236607682,1210932322,0,738,717,738,728,1054974,724,-0.086956521739131
وصنعت,2018-12-15,2319111870,199,86,3,38,2,1419067,625000,644067,1400000,1604597369,714514501,736336143,1582775727,738,706,737,707,2044067,716,-1.21845082680592
وصنعت,2018-12-16,1648908701,118,34,3,52,0,316368,1137622,1453990,0,358993702,1289914999,1648908701,0,723,706,714,717,1453990,715,-0.088105726872247
وصنعت,2018-12-17,2712061352,176,57,1,62,0,1360267,1000000,2360267,0,1560730157,1151331195,2712061352,0,731,716,731,719,2360267,724,1.32275132275132
وصنعت,2018-12-18,2514414251,157,21,2,51,0,577670,1608225,2185895,0,664375612,1850038639,2514414251,0,730,719,724,729,2185895,725,0.087032201914709
وصنعت,2018-12-19,2525422895,162,55,4,52,1,1075837,1125000,2000837,200000,1231345054,1294077841,2297060155,228362740,738,706,734,725,2200837,723,-0.260869565217391
وصنعت,2018-12-22,2211502947,167,50,1,47,1,1303959,600000,1843959,60000,1515765595,695737352,2141302947,70200000,742,728,742,735,1903959,733,1.3077593722755
وصنعت,2018-12-23,1220292894,137,50,1,45,0,1019873,20000,1039873,0,1197052894,23240000,1220292894,0,747,726,738,735,1039873,737,0.602409638554217
وصنعت,2018-12-24,828097722,97,41,1,32,0,607419,100000,707419,0,711165294,116932428,828097722,0,747,736,744,736,707419,738,0.085543199315654
وصنعت,2018-12-25,1116221007,111,44,2,35,2,842477,121700,802889,161288,974279032,141941975,929901641,186319366,739,725,738,736,964177,733,-0.598290598290598
وصنعت,2018-12-26,1653874508,180,53,2,42,0,1122529,300000,1422529,0,1305965508,347909000,1653874508,0,738,728,733,733,1422529,733,0
وصنعت,2018-12-29,9360134694,353,90,4,65,1,6489470,1471192,7901553,59109,7624023691,1736111003,9289794984,70339710,752,733,733,752,7960662,741,1.11779879621668
وصنعت,2018-12-30,6653521994,449,101,1,79,1,5459636,100000,5309636,250000,6533496906,120025088,6355210940,298311054,762,747,760,757,5559636,755,1.78571428571429
وصنعت,2018-12-31,2986409105,176,58,2,62,0,2370571,110000,2480571,0,2854339105,132070000,2986409105,0,762,755,762,760,2480571,759,0.584795321637427
وصنعت,2019-01-01,4332849105,255,47,4,77,3,2920354,616390,3463944,72800,3578177256,754671849,4242493105,90356000,788,757,762,776,3536744,772,1.74418604651163
وصنعت,2019-01-02,3062848497,210,64,2,40,0,2415657,127205,2542862,0,2908053732,154794765,3062848497,0,781,753,772,754,2542862,759,-1.71428571428571
وصنعت,2019-01-05,1501492963,116,44,1,33,1,1152445,100000,1237945,14500,1381047519,120445444,1484237963,17255000,769,748,769,750,1252445,757,-0.332225913621262
وصنعت,2019-01-06,1737641478,121,46,1,33,1,1418231,40000,1437072,21159,1689846478,47795000,1712408799,25232679,763,744,755,757,1458231,752,-0.583333333333333
وصنعت,2019-01-07,2027408079,173,65,1,47,1,1676482,10000,1649637,36845,2015478079,11930000,1983126552,44281527,767,750,757,753,1686482,758,0.754400670578374
وصنعت,2019-01-08,3738131192,226,68,1,50,0,3021925,100000,3121925,0,3618345192,119786000,3738131192,0,769,744,758,757,3121925,755,-0.415973377703827
وصنعت,2019-01-09,5161309111,289,105,2,50,2,4211263,110000,4290172,31091,5029709111,131600000,5124004403,37304708,769,747,757,756,4321263,753,-0.25062656641604
وصنعت,2019-01-12,3613997444,217,71,2,39,1,2891082,130000,2975361,45721,3458837444,155160000,3559407945,54589499,760,752,759,757,3021082,754,0.16750418760469
وصنعت,2019-01-13,2567925694,219,81,0,80,0,2136550,0,2136550,0,2567925694,0,2567925694,0,770,755,770,763,2136550,758,0.501672240802676
وصنعت,2019-01-14,16820225163,796,165,2,186,3,12817235,550000,12798017,569218,16129466206,690758957,16101968697,718256466,796,768,769,796,13367235,793,4.65890183028286
وصنعت,2019-01-15,7229109917,477,170,3,116,1,4792104,850065,5502169,140000,6135930106,1093179811,7049955349,179154568,820,799,817,813,5642169,808,1.82829888712242
وصنعت,2019-01-16,7975610067,398,83,4,70,2,2955115,3262120,4207235,2010000,3794958900,4180651167,5401696835,2573913232,820,803,818,803,6217235,809,0.156128024980484
وصنعت,2019-01-19,3440617336,213,70,1,67,1,2591560,81439,2183037,489962,3335707470,104909866,2809002261,631615075,819,804,818,809,2672999,811,0.311769290724864
وصنعت,2019-01-20,2856768401,194,64,2,52,1,1744823,515073,2259796,100,2206409833,650358568,2856639501,128900,813,789,802,791,2259896,797,-1.78710178710179
وصنعت,2019-01-21,6744492172,253,86,2,60,0,5013425,325212,5338637,0,6332970992,411521180,6744492172,0,819,788,800,799,5338637,796,-0.079113924050633
وصنعت,2019-01-22,3063551022,181,48,2,56,1,2116543,278864,2195407,200000,2707659342,355891680,2806551022,257000000,813,782,794,807,2395407,806,1.26682501979414
وصنعت,2019-01-23,13457789907,677,129,3,145,2,7384309,2914968,6989339,3309938,9655224529,3802565378,9124386104,4333403803,839,795,807,825,10299277,824,2.18921032056294
وصنعت,2019-01-26,12618962612,777,214,0,121,3,9509566,0,6462502,3047064,12618962612,0,8575006063,4043956549,849,823,823,846,9509566,837,1.53022188217292
وصنعت,2019-01-27,11656630579,569,170,5,90,4,5725350,3090201,6128677,2686874,7586350169,4070280410,8120444794,3536185785,856,826,851,832,8815551,834,-0.376789751318764
وصنعت,2019-01-28,4875585527,383,126,1,60,2,3673296,67127,2535129,1205294,4788274571,87310956,3306854364,1568731163,849,813,847,814,3740423,822,-1.43721633888048
وصنعت,2019-01-29,4635135073,377,100,2,100,2,3149240,377459,3108039,418660,4140325814,494809259,4086303259,548831814,842,810,820,839,3526699,828,0.844205679201842
وصنعت,2019-01-30,7045727383,490,140,1,124,1,5087482,155184,4242666,1000000,6837842775,207884608,5699670985,1346056398,856,829,844,844,5242666,847,2.28310502283105
وصنعت,2019-02-02,2287243679,197,91,1,47,0,1655413,67214,1722627,0,2198305129,88938550,2287243679,0,851,830,841,837,1722627,837,-1.19047619047619
وصنعت,2019-02-03,2609077204,263,96,1,64,0,1860851,150602,2011453,0,2412626602,196450602,2609077204,0,832,808,832,819,2011453,818,-2.33433734939759
وصنعت,2019-02-04,5149330755,281,87,1,77,4,3832978,75301,2939994,968285,5050761746,98569009,3867233084,1282097671,846,808,808,832,3908279,831,1.61912104857363
وصنعت,2019-02-05,2375829689,219,81,0,43,1,1825723,0,1822123,3600,2375829689,0,2371041689,4788000,839,818,839,819,1825723,820,-1.28983308042489
وصنعت,2019-02-06,2730922344,286,110,0,46,0,2131610,0,2131610,0,2730922344,0,2730922344,0,832,801,817,804,2131610,808,-1.53727901614143
وصنعت,2019-02-10,1043506001,150,54,1,49,0,732868,83355,816223,0,936906232,106599769,1043506001,0,810,801,803,807,816223,807,-0.078064012490242
وصنعت,2019-02-12,5748985211,509,149,1,43,0,4629352,10000,4639352,0,5736825211,12160000,5748985211,0,803,767,803,772,4639352,781,-3.203125
وصنعت,2019-02-13,2475907023,267,84,0,77,0,2017201,0,2017201,0,2475907023,0,2475907023,0,780,769,769,780,2017201,774,-0.968523002421308
وصنعت,2019-02-16,4515865630,303,98,1,86,0,3086078,500000,3586078,0,3878732845,637132785,4515865630,0,807,776,788,792,3586078,794,2.6079869600652
وصنعت,2019-02-17,1494535978,158,74,0,36,1,1202837,0,917891,284946,1494535978,0,1140628569,353907409,800,777,789,782,1202837,787,-0.873709293089754
وصنعت,2019-02-18,2340043125,196,99,0,40,1,1893827,0,1498773,395054,2340043125,0,1853110197,486932928,794,776,793,788,1893827,779,-0.961538461538462
وصنعت,2019-02-19,1395208246,138,42,0,60,0,1115612,0,1115612,0,1395208246,0,1395208246,0,798,776,776,791,1115612,785,0.728155339805825
وصنعت,2019-02-20,1400834436,173,60,0,47,0,1110510,0,1110510,0,1400834436,0,1400834436,0,801,790,794,800,1110510,791,0.803212851405622
وصنعت,2019-02-23,2597207022,247,75,1,77,0,1900354,118203,2018557,0,2445055640,152151382,2597207022,0,820,796,796,807,2018557,811,2.54980079681275
وصنعت,2019-02-24,1374593378,157,69,1,49,0,973181,93750,1066931,0,1253758632,120834746,1374593378,0,825,805,819,807,1066931,812,0.077700077700078
وصنعت,2019-02-25,3542353244,285,81,1,75,1,2698959,76636,2675595,100000,3445469104,96884140,3416215032,126138212,820,794,813,805,2775595,805,-0.93167701863354
وصنعت,2019-02-26,2048862649,150,66,1,39,1,1217097,400000,1617094,3,1542964945,505897704,2048858842,3807,807,791,798,795,1617097,799,-0.626959247648903
وصنعت,2019-02-27,3186461388,217,69,1,41,1,2353057,153564,2370996,135625,2992202928,194258460,3014077208,172384180,813,797,813,801,2506621,801,0.236593059936908
وصنعت,2019-03-02,1456131734,121,30,1,57,0,769155,369800,1138955,0,984537478,471594256,1456131734,0,815,796,815,809,1138955,805,0.3933910306845
وصنعت,2019-03-03,4943463296,327,109,0,53,1,3927876,0,1407143,2520733,4943463296,0,1785700640,3157762656,817,787,816,787,3927876,794,-1.33228840125392
وصنعت,2019-03-04,1401382372,139,64,0,42,0,1121367,0,1121367,0,1401382372,0,1401382372,0,799,782,799,794,1121367,790,-0.476568705321684
وصنعت,2019-03-05,9251620557,549,177,2,42,1,6779016,800000,1579016,6000000,8274787838,976832719,1938891856,7312728701,785,760,785,776,7579016,770,-2.55387071029529
وصنعت,2019-03-06,4247469858,245,79,0,30,2,3497315,0,1456666,2040649,4247469858,0,1771587113,2475882745,775,760,772,772,3497315,765,-0.573300573300573
وصنعت,2019-03-09,7061209621,330,83,1,42,1,4291654,1500000,1119427,4672227,5230372633,1830836988,1365800453,5695409168,781,763,772,772,5791654,769,0.411861614497529
وصنعت,2019-03-10,4202564747,293,95,1,54,1,2636901,800000,1436901,2000000,3228694277,973870470,1760868154,2441696593,785,763,764,782,3436901,771,0.328137817883511
وصنعت,2019-03-13,18957728752,780,121,2,211,5,12736144,1886459,8366920,6255683,16530298874,2427429878,10826050244,8131678508,824,785,785,805,14622603,817,5.96892886345053
وصنعت,2019-03-16,6768537771,429,114,0,145,3,5201437,0,3036432,2165005,6768537771,0,3950729312,2817808459,829,798,798,818,5201437,820,0.385802469135802
وصنعت,2019-03-17,4979767740,338,79,1,91,4,3768563,6615,1176660,2598518,4970956955,8810785,1562850999,3416916741,851,820,821,837,3775178,832,1.38355111452729
وصنعت,2019-03-18,3460842034,305,98,0,111,1,2564953,0,1564953,1000000,3460842034,0,2110041127,1350800907,859,839,845,856,2564953,851,2.27445034116755
وصنعت,2019-03-19,8921663018,389,110,1,108,3,5123068,1384354,2733122,3774300,7016204459,1905458559,3744726196,5176936822,876,852,852,874,6507422,864,1.63083765752409
وصنعت,2019-03-25,11824981018,484,89,0,97,3,8382922,0,3852922,4530000,11824981018,0,5439803302,6385177716,906,866,881,894,8382922,890,2.91757840991977
وصنعت,2019-03-26,14471548380,627,136,0,111,2,9979990,0,5609990,4370000,14471548380,0,8140123019,6331425361,933,890,905,914,9979990,914,2.76399716513111
وصنعت,2019-03-27,10546654075,664,201,0,112,1,7315825,0,6325225,990600,10546654075,0,9117650559,1429003516,924,895,916,906,7315825,909,-0.551724137931034
وصنعت,2019-03-30,10598270327,513,144,2,89,3,5622313,1700000,3542476,3779837,8133880511,2464389816,5123190113,5475080214,917,900,909,914,7322313,912,0.346740638002774
وصنعت,2019-03-31,12683088495,574,159,1,106,3,8712140,50000,6515021,2247119,12610758495,72330000,9425505346,3257583149,927,902,919,909,8762140,912,0
وصنعت,2019-04-06,9181079108,435,119,1,92,3,6004294,344150,4431626,1916818,8682006608,499072500,6402790066,2778289042,924,905,908,914,6348444,912,-0.069108500345543
وصنعت,2019-04-07,19722618875,789,224,2,95,3,11702202,2110000,12815326,996876,16663901875,3058717000,18275310796,1447308079,926,866,914,876,13812202,900,-1.2448132780083
وصنعت,2019-04-08,21313348514,891,167,2,223,1,13495446,1069402,14554848,10000,19791372196,1521976318,21298358514,14990000,945,876,883,931,14564848,922,2.45098039215686
وصنعت,2019-04-09,10131364074,483,170,0,87,3,6896381,0,5287237,1609144,10131364074,0,7756038446,2375325628,941,908,925,915,6896381,926,0.410116199589884
وصنعت,2019-04-10,13421699115,674,219,0,115,4,9118432,0,7498544,1619888,13421699115,0,11012259756,2409439359,943,909,909,924,9118432,928,0.204220558202859
وصنعت,2019-04-13,12997924902,771,208,0,113,3,8905659,0,6728806,2176853,12997924902,0,9820405663,3177519239,936,912,924,927,8905659,921,-0.815217391304348
وصنعت,2019-04-14,17528849369,721,150,0,106,4,11988692,0,10226192,1762500,17528849369,0,14954030390,2574818979,930,912,929,927,11988692,922,0.136986301369863
وصنعت,2019-04-15,18485967852,819,219,0,147,4,12323889,0,7710286,4613603,18485967852,0,11560522597,6925445255,958,926,926,936,12323889,946,2.59917920656635
وصنعت,2019-04-16,13889083804,691,189,0,92,0,9532456,0,9532456,0,13889083804,0,13889083804,0,939,905,933,929,9532456,919,-2.86666666666667
وصنعت,2019-04-20,15409966071,739,197,1,225,2,9798236,170000,8368236,1600000,15145516071,264450000,12955534720,2454431351,993,949,965,984,9968236,975,6.10844200411805
وصنعت,2019-04-22,7105877065,429,177,1,115,1,4625738,9061,4101102,533697,7092013735,13863330,6289954702,815922363,1007,946,1006,952,4634799,967,-0.840879689521345
وصنعت,2019-04-23,5751436814,328,110,1,96,2,3715309,100000,3455309,360000,5601436814,150000000,5203020914,548415900,970,936,936,956,3815309,950,-1.69602087410307
وصنعت,2019-04-24,15675550922,636,104,3,234,3,8459020,1606850,9029026,1036844,13146711596,2528839326,14085367642,1590183280,997,940,940,997,10065870,982,3.3178500331785
وصنعت,2019-04-27,13190258838,345,36,1,120,3,3805629,4276455,3572616,4509468,6208279985,6981978853,5821788126,7368470712,1030,1011,1018,1030,8082084,1029,4.81695568400771
وصنعت,2019-04-28,68194386390,1905,496,6,371,4,38152039,1708388,23970367,15890060,65271798548,2922587842,40976787206,27217599184,1080,1048,1080,1078,39860427,1079,4.8406862745098
وصنعت,2019-04-29,17221836975,1026,285,2,232,3,10145822,122104,9678477,589449,17015994219,205842756,16241065041,980771934,1096,1041,1096,1056,10267926,1057,-1.98714202220923
وصنعت,2019-04-30,13883714828,703,184,3,223,1,6384017,1792891,8076908,100000,10854714341,3029000487,13713159078,170555750,1086,1037,1072,1084,8176908,1071,1.25223613595707
وصنعت,2019-05-01,24689731350,702,72,3,228,4,4535319,9407109,11507428,2435000,8017360917,16672370433,20350561350,4339170000,1124,1041,1072,1124,13942428,1117,4.29917550058893
وصنعت,2019-05-04,27581401848,864,220,1,167,3,14800760,50000,9220760,5630000,27488479996,92921852,17117981219,10463420629,1172,1135,1141,1172,14850760,1171,4.85601355166573
وصنعت,2019-05-05,25735129278,1035,288,2,230,2,13525199,648521,14152720,21000,24563854095,1171275183,25697316278,37813000,1210,1113,1180,1150,14173720,1145,-2.20786214324179
وصنعت,2019-05-06,26653104762,844,254,5,173,1,9401580,5979542,12381122,3000000,16298621775,10354482987,21462931665,5190173097,1180,1088,1148,1088,15381122,1093,-4.5704845814978
وصنعت,2019-05-07,22949970787,890,236,4,251,0,11338526,2470537,13809063,0,18818247614,4131723173,22949970787,0,1078,1038,1050,1072,13809063,1048,-4.09694171956145
وصنعت,2019-05-08,27780537413,746,175,4,198,2,9470683,6500000,13470683,2500000,16458200615,11322336798,23418037413,4362500000,1100,1071,1071,1100,15970683,1096,4.63297232250301
وصنعت,2019-05-11,40968600965,1033,201,2,255,4,20246544,2377000,19043544,3580000,36646356295,4322244670,34487729184,6480871781,1151,1100,1121,1151,22623544,1142,4.14031052328925
وصنعت,2019-05-12,32642746066,1023,215,2,216,4,17672882,1020000,10370754,8322128,30887326066,1755420000,18307851775,14334894291,1166,1085,1161,1141,18692882,1101,-3.58917725013805
وصنعت,2019-05-13,21874510372,701,153,2,193,5,11672294,270000,10614994,1327300,21379600372,494910000,19441788472,2432721900,1156,1133,1148,1156,11942294,1155,4.92554410080183
وصنعت,2019-05-14,18131989448,727,215,2,136,1,9513158,230000,9610937,132221,17704806734,427182714,17885079096,246910352,1201,1155,1166,1166,9743158,1173,1.58296943231441
وصنعت,2019-05-15,46377757278,1387,206,1,363,5,22872779,1000000,17362779,6510000,44423794009,1953963269,33657217278,12720540000,1232,1140,1183,1232,23872779,1225,4.40623320795271
وصنعت,2019-05-18,62335514450,1517,255,4,255,6,22744123,7900000,8197433,22446690,46311298813,16024215637,16624742094,45710772356,1286,1254,1261,1286,30644123,1282,4.68347915594442
وصنعت,2019-05-19,29611106712,987,182,3,205,4,14058399,637835,10779882,3916352,28327625972,1283480740,21755072299,7856034413,1314,1219,1308,1294,14696234,1270,-0.934119960668633
وصنعت,2019-05-20,13023406607,518,101,3,146,1,5287914,1211000,6488914,10000,10593529740,2429876867,13003256607,20150000,1307,1236,1267,1285,6498914,1264,-0.54590570719603
وصنعت,2019-05-21,16384856778,634,146,3,128,3,7428070,595000,4375561,3647509,15163086778,1221770000,8984527287,7400329491,1320,1261,1293,1286,8023070,1287,1.89620758483034
وصنعت,2019-05-22,11473916567,451,109,3,109,2,4749250,902000,4174211,1477039,9645685320,1828231247,8470785367,3003131200,1305,1262,1262,1278,5651250,1280,-0.587659157688541
وصنعت,2019-05-25,16823257378,640,108,5,132,2,7193426,974231,7306657,861000,14824235002,1999022376,15053813484,1769443894,1323,1277,1308,1297,8167657,1299,1.47783251231527
وصنعت,2019-05-26,35334496536,1029,166,1,238,5,16364293,55000,9817293,6602000,35215531536,118965000,21066332536,14268164000,1364,1295,1311,1364,16419293,1357,4.46601941747573
وصنعت,2019-05-28,14168497973,717,219,4,128,8,6376794,173000,4350392,2199402,13787478192,381019781,9418230752,4750267221,1418,1337,1383,1356,6549794,1364,0.511152416356877
وصنعت,2019-05-29,19642315680,744,236,4,144,1,8117911,886746,8824410,180247,17737544987,1904770693,19244756178,397559502,1431,1332,1431,1349,9004657,1375,0.832177531206657
وصنعت,2019-06-01,14286858338,568,176,3,117,3,4520902,2171598,5535476,1157024,9609997487,4676860851,11834148907,2452709431,1373,1311,1373,1349,6692500,1346,-2.10912425492893
وصنعت,2019-06-02,27964660754,807,193,3,95,5,10642479,2442006,6688373,6396112,22736083288,5228577466,14344839450,13619821304,1366,1318,1366,1346,13084485,1347,0.09367681498829
وصنعت,2019-06-03,16297984265,640,164,1,106,4,7675157,20000,3918053,3777104,16255084265,42900000,8341096752,7956887513,1362,1323,1356,1339,7695157,1335,-0.889096864763687
وصنعت,2019-06-08,14500044319,492,145,3,98,3,6207674,645868,3851201,3002341,13130208435,1369835884,8161140175,6338904144,1351,1311,1327,1349,6853542,1334,-0.094428706326723
وصنعت,2019-06-09,32740252782,843,179,1,165,5,14532951,228782,7683220,7078513,32232136742,508116040,17019011533,15721241249,1400,1349,1349,1400,14761733,1398,4.82041587901701
وصنعت,2019-06-10,20985962616,647,179,1,151,5,8865550,360000,6256643,2968907,20162122254,823840362,14231875618,6754086998,1467,1400,1419,1415,9225550,1434,2.56988277727683
وصنعت,2019-06-11,14807102050,590,187,2,81,3,6330771,300000,3258177,3372594,14137502050,669600000,7297031035,7510071015,1431,1393,1400,1400,6630771,1408,-1.84615384615385
وصنعت,2019-06-12,69201599402,2118,639,10,144,6,27815553,4640000,19599112,12856441,59353869402,9847730000,41836593178,27365006224,1401,1338,1387,1338,32455553,1344,-4.5230631437528
وصنعت,2019-06-15,23487539339,785,204,5,131,4,7197559,3786912,6495288,4489183,15369472908,8118066431,13906545729,9580993610,1367,1324,1344,1354,10984471,1348,0.281425891181989
وصنعت,2019-06-16,15571951415,637,154,3,156,2,5687802,1516390,4502169,2702023,12286269654,3285681761,9701221135,5870730280,1393,1325,1368,1349,7204192,1363,1.12254443405051
وصنعت,2019-06-17,14134680648,572,136,5,164,0,5646214,1041298,6687512,0,11916874147,2217806501,14134680648,0,1363,1295,1349,1348,6687512,1333,-2.22016651248844
وصنعت,2019-06-18,51653344400,1254,182,3,290,2,22848856,565000,13313856,10100000,50404144400,1249200000,29304004856,22349339544,1399,1317,1317,1395,23413856,1391,4.3519394512772
وصنعت,2019-06-19,98174394390,2235,433,1,314,6,42421961,160296,26298450,16283807,97803148854,371245536,60490605949,37683788441,1460,1419,1460,1460,42582257,1454,4.53309156844968
وصنعت,2019-06-22,29300619676,1283,262,3,256,2,12255410,160000,10630781,1784629,28925249511,375370165,25027315412,4273304264,1525,1406,1419,1510,12415410,1488,2.3417172593235
وصنعت,2019-06-23,27744993848,1000,244,2,212,2,10574809,1104827,10563032,1116604,25155221182,2589772666,25118478176,2626515672,1545,1466,1477,1479,11679636,1498,0.677966101694915
وصنعت,2019-06-24,19877150684,833,252,0,163,1,8546447,0,4623311,3923136,19877150684,0,10739061113,9138089571,1513,1450,1482,1463,8546447,1467,-2.1043771043771
وصنعت,2019-06-25,31833879660,1112,335,2,143,0,14147489,70000,14217489,0,31678579660,155300000,31833879660,0,1450,1393,1450,1431,14217489,1412,-3.74032674118659
وصنعت,2019-06-26,14720058200,583,194,0,123,1,6540468,0,5691683,848785,14720058200,0,12810731383,1909326817,1467,1407,1410,1425,6540468,1419,0.535953550692273
وصنعت,2019-06-30,22720084287,701,180,1,127,3,10145345,10000,8437185,1718160,22698384287,21700000,18845984499,3874099788,1448,1363,1423,1406,10155345,1410,-0.621945801865837
وصنعت,2019-07-01,13798297129,529,164,3,97,0,6107538,195862,6303400,0,13368485191,429811938,13798297129,0,1408,1368,1369,1379,6303400,1380,-2.14573088958426
وصنعت,2019-07-02,21302426481,888,298,0,94,1,9848538,0,6057950,3790588,21302426481,0,13102970605,8199455876,1387,1352,1387,1375,9848538,1364,-1.18775696665144
وصنعت,2019-07-03,45861344935,1218,374,5,108,1,17984861,3064000,2855264,18193597,39161663347,6699681588,6232751575,39628593360,1392,1362,1386,1380,21048861,1374,0.739713361072584
وصنعت,2019-07-06,29701582032,966,239,3,150,1,11940441,1483955,10969822,2454574,26409135417,3292446615,24271787250,5429794782,1411,1377,1387,1400,13424396,1395,1.5603487838458
وصنعت,2019-07-07,33579061420,1185,273,2,291,2,14398406,141912,13240318,1300000,33251809880,327251540,30585972703,2993088717,1465,1402,1415,1465,14540318,1456,4.33800271125169
وصنعت,2019-07-08,21440711061,923,299,1,177,1,8994281,30000,8994281,30000,21369671061,71040000,21369491061,71220000,1513,1467,1467,1501,9024281,1498,2.9016890428757
وصنعت,2019-07-09,33264879329,1523,369,4,164,2,13368848,1200000,9038878,5529970,30529388514,2735490815,20691753225,12573126104,1493,1424,1493,1424,14568848,1439,-3.91414141414141
وصنعت,2019-07-10,24140523115,872,189,4,139,1,10081717,630048,9241735,1470030,22713058439,1427464676,20801951557,3338571558,1438,1409,1416,1426,10711765,1421,-1.27025843188787
وصنعت,2019-07-13,19533038367,783,198,2,215,0,8513553,210456,8724009,0,19061872367,471166000,19533038367,0,1449,1401,1449,1422,8724009,1412,-0.665483584738243
وصنعت,2019-07-14,11551319477,613,220,0,112,1,5097817,0,4597817,500000,11551319477,0,10418633542,1132685935,1456,1419,1435,1431,5097817,1429,1.20589548905762
وصنعت,2019-07-15,11945965394,659,205,2,120,0,5269420,20572,5289992,0,11899772102,46193292,11945965394,0,1450,1388,1430,1426,5289992,1424,-0.353045013239188
وصنعت,2019-07-16,14503952989,668,324,2,79,0,6595468,130000,6725468,0,14224972989,278980000,14503952989,0,1419,1353,1419,1353,6725468,1360,-4.47298494242693
وصنعت,2019-07-17,17724180076,831,375,2,125,2,7998618,220000,8208046,10572,17249930076,474250000,17701379704,22800372,1405,1308,1353,1349,8218618,1360,0
وصنعت,2019-07-20,17062017679,797,308,1,105,1,8044217,10000,8044758,9459,17041017679,21000000,17041614616,20403063,1381,1317,1381,1342,8054217,1335,-1.80806675938804
وصنعت,2019-07-21,11263666762,574,177,3,133,1,5106940,62890,5159830,10000,11126708697,136958065,11241436762,22230000,1402,1330,1349,1400,5169830,1374,2.88007554296506
وصنعت,2019-07-22,6732488070,416,178,1,87,0,3002817,50000,3052817,0,6622547973,109940097,6732488070,0,1425,1375,1425,1387,3052817,1390,1.19320789352914
وصنعت,2019-07-23,8625296795,606,188,1,93,2,3949500,5000,3630304,324196,8614271795,11025000,7921046611,704250184,1406,1362,1406,1362,3954500,1375,-1.08843537414966
وصنعت,2019-07-24,12384205998,534,195,1,79,1,4653494,1000000,5621250,32244,10192625780,2191580218,12313630582,70575416,1399,1368,1368,1381,5653494,1381,0.458505272810637
وصنعت,2019-07-27,9545144467,535,174,0,158,0,4245260,0,4245260,0,9545144467,0,9545144467,0,1434,1400,1412,1422,4245260,1417,2.60155180282976
وصنعت,2019-07-28,6639715284,396,141,2,93,0,2783032,187000,2970032,0,6220319129,419396155,6639715284,0,1431,1397,1404,1397,2970032,1410,-0.533807829181495
وصنعت,2019-07-29,7965206935,441,165,2,91,1,3088519,489435,3076754,501200,6872515718,1092691217,6847419629,1117787306,1431,1387,1412,1396,3577954,1404,-0.447227191413238
وصنعت,2019-07-30,7576727178,419,157,0,84,1,3418055,0,2328055,1090000,7576727178,0,5156760778,2419966400,1425,1391,1396,1393,3418055,1398,-0.404312668463612
وصنعت,2019-07-31,13818981699,553,113,4,154,1,2258675,3913247,5181922,990000,5041184595,8777797104,11611961699,2207020000,1447,1381,1393,1447,6171922,1412,0.99233198015336
وصنعت,2019-08-03,6100290325,423,159,2,121,2,2487885,182334,2656419,13800,5684407055,415883270,6068839041,31451284,1463,1427,1463,1442,2670219,1441,2.05448861098705
وصنعت,2019-08-04,25147621136,913,166,3,330,2,9480454,1099060,10474514,105000,22571623104,2575998032,24896126136,251495000,1513,1430,1430,1513,10579514,1499,4.02625820568928
وصنعت,2019-08-05,38174670264,1374,334,2,312,7,13103333,2321750,13178989,2246094,32393296294,5781373970,32588735739,5585934525,1573,1514,1529,1557,15425083,1561,4.12284392090871
وصنعت,2019-08-06,27936146351,786,187,2,223,6,11035386,220000,9747928,1507458,27386646351,549500000,24185646713,3750499638,1605,1549,1593,1574,11255386,1565,0.282828282828283
وصنعت,2019-08-07,26906734237,761,190,3,149,3,10389284,411000,7999402,2800882,25888432237,1018302000,19979833767,6926900470,1605,1552,1565,1570,10800284,1571,0.362610797743755
وصنعت,2019-08-10,14303252205,620,198,2,177,2,5364713,420000,5752814,31899,13264152205,1039100000,14224349034,78903171,1593,1545,1593,1550,5784713,1559,-0.722601364913689
وصنعت,2019-08-11,10509226030,526,227,0,106,1,4284700,0,4268437,16263,10509226030,0,10469359454,39866576,1569,1535,1545,1538,4284700,1547,-0.808734330772341
وصنعت,2019-08-13,15804725145,778,290,2,107,2,5684221,842668,6481313,45576,13744946583,2059778562,15693810752,110914393,1568,1502,1545,1532,6526889,1526,-1.30452507134121
وصنعت,2019-08-14,29786608018,845,214,3,253,2,9323203,2500000,11710203,113000,23513662233,6272945785,29499388018,287220000,1603,1526,1526,1594,11823203,1588,4.04791408508881
وصنعت,2019-08-17,21856529693,729,185,1,232,3,7496957,900000,5951419,2445538,19521832033,2334697660,15512742277,6343787416,1667,1583,1627,1624,8396957,1641,3.33465660976578
وصنعت,2019-08-18,33889001882,1157,341,6,106,2,7875089,5550000,11349300,2075789,19811777232,14077224650,28617975393,5271026489,1665,1570,1665,1586,13425089,1591,-3.03495966192854
وصنعت,2019-08-19,5770086111,373,124,1,136,2,2219588,47720,1685508,581800,5648877311,121208800,4297207163,1472878948,1627,1583,1583,1614,2267308,1605,0.832012678288431
وصنعت,2019-08-21,11476733617,481,153,2,129,4,3277711,1150000,3389853,1037858,8494335517,2982398100,8792495113,2684238504,1661,1595,1640,1627,4427711,1634,1.8467583497053
وصنعت,2019-08-24,25387386097,902,312,2,182,6,9396130,210000,6480989,3125141,24839039717,548346380,17129071954,8258314143,1713,1627,1639,1694,9606130,1666,1.96759259259259
وصنعت,2019-08-25,83494171418,1666,361,1,334,10,25292695,5000000,16564130,13728565,69696270960,13797900458,45669769820,37824401598,1750,1673,1673,1750,30292695,1738,4.27544457056375
وصنعت,2019-08-26,53019818147,1186,417,3,176,2,15403955,3300000,18203955,500000,43675213269,9344604878,51605318147,1414500000,1816,1751,1816,1794,18703955,1787,2.86647314949202
وصنعت,2019-08-27,49449880546,1570,481,5,194,2,15492125,2190000,14159449,3522676,43377945320,6071935226,39603213965,9846666581,1820,1704,1815,1721,17682125,1764,-1.34038800705467
وصنعت,2019-08-28,83162595289,1638,322,1,301,1,29418503,200000,29598503,20000,82598495289,564100000,83105725289,56870000,1851,1702,1711,1846,29618503,1770,0.39327851269217
وصنعت,2019-08-31,165867703902,1790,287,6,311,6,37727081,18693208,50529981,5890308,110838636882,55029067020,148503125918,17364577984,1859,1797,1828,1859,56420289,1854,4.7008547008547
وصنعت,2019-09-01,103957834707,1232,122,4,194,5,28693033,5105000,14599033,19199000,88258079707,15699755000,44727521707,59230313000,1946,1898,1923,1946,33798033,1939,4.62585034013605
وصنعت,2019-09-02,215051299187,3743,1039,10,533,8,62905472,4537065,52063502,15379035,200629395017,14421904170,165465519326,49585779861,2036,1933,2036,2004,67442537,2011,3.67360208062419
وصنعت,2019-09-03,44375183984,1398,457,4,307,2,10975464,2904484,12519357,1360591,35055075355,9320108629,40077106283,4298077701,2066,1973,2005,1986,13879948,2016,0.250862339291314
وصنعت,2019-09-04,51019316078,1595,489,2,277,7,14610913,1620000,13954597,2276316,45876452089,5142863989,43840413685,7178902393,2039,1924,2016,1942,16230913,1982,-1.68908351579606
وصنعت,2019-09-07,30769049525,1451,609,4,266,1,9574483,476520,9548370,502633,29307743525,1461306000,29223444970,1545604555,1992,1883,1986,1942,10051003,1930,-2.60897231944003
وصنعت,2019-09-08,42260455791,1479,610,2,198,2,13523600,254480,11051287,2726793,41483024391,777431400,33907867774,8352588017,1998,1922,1945,1930,13778080,1934,0.196014374387455
وصنعت,2019-09-11,26997281669,840,302,3,202,2,8477193,210000,7553703,1133490,26343111669,654170000,23465698439,3531583230,2005,1917,1977,1958,8687193,1960,1.33681121617216
وصنعت,2019-09-14,40531685669,1620,558,2,290,1,12867675,220000,13021165,66510,39844105669,687580000,40324196301,207489368,2018,1923,1973,1933,13087675,1953,-0.353925353925354
وصنعت,2019-09-15,37176032370,1098,399,4,211,2,10692287,1421863,11509150,605000,32830027024,4346005346,35329636038,1846396332,1962,1914,1914,1922,12114150,1935,-0.904100742654182
وصنعت,2019-09-16,51011195128,1161,231,3,308,4,5823963,10522268,13942356,2403875,18120631434,32890563694,43491767327,7519427801,2002,1925,1947,2000,16346231,1968,1.69436298468557
وصنعت,2019-09-17,45468538620,1359,329,6,300,1,8303820,5957022,14242139,18703,26529815963,18938722657,45408635870,59902750,2062,1977,1999,2008,14260842,2010,2.14674783723166
وصنعت,2019-09-18,42021047446,1314,393,6,164,0,10567871,3129161,13697032,0,32394579618,9626467828,42021047446,0,1999,1910,1980,1967,13697032,1934,-3.76411543287328
وصنعت,2019-09-21,9996089107,514,166,1,149,1,3038080,150000,3180580,7500,9526130081,469959026,9972434107,23655000,1999,1955,1993,1974,3188080,1977,2.18383311603651
وصنعت,2019-09-22,35958349110,1161,396,1,262,3,11026994,150000,11112574,64420,35482849110,475500000,35752998940,205350170,2073,1986,2054,2019,11176994,2028,2.61562998405104
وصنعت,2019-09-23,24077461692,1055,301,3,253,1,6245764,1150000,7375764,20000,20333591094,3743870598,24012414692,65047000,2080,2004,2004,2050,7395764,2053,1.21230960522226
وصنعت,2019-09-24,31359871725,1338,441,3,173,0,9695414,194311,9889725,0,30747427436,612444289,31359871725,0,2074,1973,2074,1977,9889725,1999,-2.61056511056511
وصنعت,2019-09-25,16787994481,803,246,1,240,0,5280213,10000,5290213,0,16756594481,31400000,16787994481,0,2043,1977,2018,2016,5290213,2001,0.063071586250394
وصنعت,2019-09-28,32622071716,1265,483,1,260,1,10084344,100000,10132344,52000,32299371716,322700000,32454059716,168012000,2048,1999,2024,2038,10184344,2020,0.945477466120391
وصنعت,2019-09-29,22089035921,787,253,4,219,0,5188396,1718347,6906743,0,16589850131,5499185790,22089035921,0,2048,1987,2048,2035,6906743,2016,-0.156103652825476
وصنعت,2019-09-30,44545872881,1170,304,5,252,1,9248632,4490697,12739329,1000000,29958027730,14587845151,41319985864,3225887017,2070,2018,2020,2062,13739329,2044,1.37585991244528
وصنعت,2019-10-01,54776994049,1634,342,2,432,4,13751291,2492230,14543521,1700000,46400913242,8376080807,49080124083,5696869966,2146,2074,2074,2136,16243521,2126,4.0098704503393
وصنعت,2019-10-02,17330724776,825,288,2,186,1,5076334,100293,5166627,10000,16994225646,336499130,17297004776,33720000,2175,2025,2113,2130,5176627,2111,-0.711743772241993
وصنعت,2019-10-05,15962419674,1004,321,2,203,0,4785723,80000,4865723,0,15700139674,262280000,15962419674,0,2143,2028,2128,2038,4865723,2069,-2.00119474313023
وصنعت,2019-10-06,11603780108,713,241,1,148,0,3601641,30989,3632630,0,11504305418,99474690,11603780108,0,2072,1987,2047,2018,3632630,2014,-2.6516306004267
وصنعت,2019-10-07,9070821704,587,198,2,162,1,2836413,13091,2749504,100000,9029511236,41310468,8750821704,320000000,2049,1975,2018,1985,2849504,2007,-0.344395742016281
وصنعت,2019-10-08,28545742107,986,323,3,197,0,9005117,303300,9308417,0,27625557007,920185100,28545742107,0,2010,1907,2010,1917,9308417,1934,-3.64436066603833
وصنعت,2019-10-09,8980904322,557,160,0,241,0,2907908,0,2907908,0,8980904322,0,8980904322,0,1992,1892,1892,1986,2907908,1947,0.684708183893055
وصنعت,2019-10-12,13835447291,584,244,2,92,1,3928990,510000,4433004,5986,12248747291,1586700000,13816597377,18849914,1999,1943,1943,1985,4438990,1965,0.939119170984456
وصنعت,2019-10-13,6616541501,421,181,0,126,0,2122327,0,2122327,0,6616541501,0,6616541501,0,2011,1945,1986,1960,2122327,1966,0.032082130253449
وصنعت,2019-10-14,17569081186,791,411,2,90,0,5549202,320000,5869202,0,16613421186,955660000,17569081186,0,1973,1868,1973,1904,5869202,1887,-4.00898011545863
وصنعت,2019-10-15,15398023891,818,341,3,165,1,4857876,500319,5158195,200000,13964011852,1434012039,14828735609,569288282,1953,1793,1892,1803,5358195,1812,-3.97594386902773
وصنعت,2019-10-16,20160350253,676,223,3,144,4,4550537,2421716,5569261,1402992,13140132337,7020217916,16093735745,4066614508,1885,1770,1828,1828,6972253,1823,0.626304801670146
وصنعت,2019-10-20,23305704594,753,177,5,206,3,5165108,3063000,6826919,1401189,14689202393,8616502201,19305328018,4000376576,1876,1759,1830,1829,8228108,1786,-2.0746887966805
وصنعت,2019-10-21,13064359687,508,162,4,152,3,3350406,1103000,3753406,700000,9859435065,3204924622,11001319297,2063040390,1874,1785,1785,1874,4453406,1850,3.60169491525424
وصنعت,2019-10-22,16198376661,655,283,0,141,2,5284488,0,5001488,283000,16198376661,0,15329736661,868640000,1942,1892,1940,1942,5284488,1933,4.46489434219496
وصنعت,2019-10-23,10460964029,506,232,0,128,1,3396546,0,2996546,400000,10460964029,0,9236705400,1224258629,1980,1923,1951,1942,3396546,1942,0.489396411092985
وصنعت,2019-10-26,5011871864,383,195,1,67,0,1631159,10000,1641159,0,4981671864,30200000,5011871864,0,1973,1898,1945,1923,1641159,1927,-0.779220779220779
وصنعت,2019-10-28,15127870062,643,204,2,122,2,4451750,370727,1822477,3000000,13964801408,1163068654,5708413991,9419456071,1986,1929,1941,1981,4822477,1978,2.65052356020942
وصنعت,2019-10-30,15082407486,756,303,4,160,2,4417155,312657,3694558,1035254,14085766446,996641040,11789064291,3293343195,2059,1988,2005,2052,4729812,2011,1.65763468281798
وصنعت,2019-11-02,13636805455,769,295,3,185,3,3631450,611830,3391975,851305,11667821740,1968983715,10910730552,2726074903,2071,1980,2062,2009,4243280,2026,0.783944810285356
وصنعت,2019-11-03,14820967307,571,187,4,140,2,2047866,2576669,2604535,2020000,6561287248,8259680059,8347067307,6473900000,2043,1987,2016,2021,4624535,2021,-0.280024891101431
وصنعت,2019-11-04,11717830791,544,196,3,117,2,3081883,657881,3576591,163173,9655882632,2061948159,11199737482,518093309,2021,1936,1989,1972,3739764,1975,-2.24648985959438
وصنعت,2019-11-05,4316105374,289,115,1,105,0,1337344,37500,1374844,0,4198544305,117561069,4316105374,0,1997,1949,1975,1982,1374844,1979,0.1595914458985
وصنعت,2019-11-09,55138114085,1428,361,4,268,4,15042647,1868990,4652371,12259266,49085278740,6052835345,15240482964,39897631121,2076,2018,2074,2045,16911637,2055,3.88782664117272
وصنعت,2019-11-10,29312927425,1107,434,4,144,2,8455233,835423,8245232,1045424,26701477735,2611449690,25936864737,3376062688,2103,1953,2072,1990,9290656,1989,-3.22085889570552
وصنعت,2019-11-11,13383537764,565,221,2,91,2,4205893,41500,2619308,1628085,13252700814,130836950,8259913830,5123623934,2018,1970,1989,1992,4247393,1987,-0.126782884310618
وصنعت,2019-11-12,10697888984,478,186,1,96,1,3251128,111000,1364088,1998040,10345491061,352397923,4339057229,6358831755,2030,1987,1992,2018,3362128,2006,0.98381466201206
وصنعت,2019-11-13,11619246275,572,176,3,131,1,3190704,446886,2361404,1276186,10192291695,1426954580,7535315900,4083930375,2028,1999,2018,2027,3637590,2014,0.377121307353865
وصنعت,2019-11-16,7895522213,512,175,4,128,0,2221326,257614,2478940,0,7074250346,821271867,7895522213,0,2067,1996,2028,1996,2478940,2008,-0.281778334376957
وصنعت,2019-11-17,9658932660,499,181,3,108,0,3083024,48300,3131324,0,9508528419,150404241,9658932660,0,1999,1929,1973,1936,3131324,1945,-3.13971742543171
وصنعت,2019-11-18,17553712122,669,161,1,165,3,5467463,30000,3669415,1828048,17461312122,92400000,11697816769,5855895353,2042,1937,1942,2005,5497463,2013,3.50081037277147
وصنعت,2019-11-19,10156402793,580,174,1,127,1,3153953,10000,2258482,905471,10124602793,31800000,7263790431,2892612362,2055,1975,2017,2008,3163953,2024,0.532414657062324
وصنعت,2019-11-20,9498108934,516,237,5,75,1,2954904,44000,2989757,9147,9358650918,139458016,9468826795,29282139,2049,1986,1996,1995,2998904,1997,-1.33956386292835
وصنعت,2019-11-23,12839709448,689,239,3,105,0,3989849,58750,4048599,0,12653343588,186365860,12839709448,0,2037,1991,2018,1993,4048599,1999,0.126302494474266
وصنعت,2019-11-24,25211209249,1115,245,3,295,4,7671017,76882,6382881,1365018,24962343289,248865960,20770398833,4440810416,2081,1999,2002,2069,7747899,2052,2.61747082939136
وصنعت,2019-11-25,29195268698,1250,439,1,140,3,9071407,10000,8457635,623772,29163368698,31900000,27196831052,1998437646,2079,2000,2059,2028,9081407,2027,-1.19852489244007
وصنعت,2019-11-26,36064335916,1328,416,1,143,4,11335579,10000,9033979,2311600,36032535916,31800000,28729591349,7334744567,2046,1986,1995,1998,11345579,2004,-1.11975116640747
وصنعت,2019-11-27,30652977533,1192,373,1,206,1,9629701,15000,9087309,557392,30605258093,47719440,28880185985,1772791548,2039,1987,1997,2037,9644701,2004,-0.031456432840516
وصنعت,2019-11-30,66212189326,2567,751,0,447,4,20324110,0,18458684,1865426,66212189326,0,60167468563,6044720763,2081,2012,2039,2068,20324110,2054,2.51730648206419
وصنعت,2019-12-07,37881671428,1639,640,3,270,1,12539384,561528,13081828,19084,36258442232,1623229196,37826327828,55343600,2187,2085,2187,2113,13100912,2108,2.62597586941093
وصنعت,2019-12-08,35654792726,1677,682,4,313,2,11297809,1048000,11803816,541993,32626804652,3027988074,34084472313,1570320413,2147,2078,2099,2125,12345809,2105,-0.138312586445367
وصنعت,2019-12-09,32068809948,1293,514,3,255,1,9888602,1103000,10451602,540000,28835167013,3233642935,30486009948,1582800000,2150,2101,2124,2150,10991602,2127,1.0387811634349
وصنعت,2019-12-10,31982167813,1499,608,1,291,1,10743148,10000,10716673,36475,31952447813,29720000,31872742813,109425000,2187,2129,2172,2133,10753148,2168,1.91912268677176
وصنعت,2019-12-11,29300095104,1120,492,2,196,1,9833977,135000,9737521,231456,28904071479,396023625,28614252974,685842130,2180,2115,2143,2143,9968977,2142,-1.1768661735037
وصنعت,2019-12-14,42578045485,1789,694,3,276,2,14522894,100000,13301919,1320975,42286965485,291080000,38741017602,3837027883,2165,2107,2165,2118,14622894,2123,-0.918679823069071
وصنعت,2019-12-15,37665506482,1426,545,2,285,2,11661195,1347493,12226900,781788,33777611176,3887895306,35396679363,2268827119,2142,2096,2114,2105,13008688,2110,-0.583791208791209
وصنعت,2019-12-16,26892597990,1237,544,3,244,1,7691685,1597507,9035341,253851,22281767274,4610830716,26149517580,743080410,2138,2096,2134,2111,9289192,2110,0
وصنعت,2019-12-17,24458086688,1119,460,2,272,1,8409143,40000,8447696,1447,24342436688,115650000,24453862895,4223793,2128,2099,2128,2113,8449143,2110,0
وصنعت,2019-12-18,39471736204,1440,507,0,359,1,13609124,0,13024006,585118,39471736204,0,37748104809,1723631395,2161,2100,2126,2158,13609124,2114,0.172711571675302
وصنعت,2019-12-21,68580156446,1319,462,0,330,3,22590106,0,9794557,12795549,68580156446,0,29617709741,38962446705,2220,2136,2136,2220,22590106,2213,4.68965517241379
وصنعت,2019-12-22,79515148349,2617,896,1,505,2,25613499,20000,23358790,2274709,79453448349,61700000,72473623892,7041524457,2303,2238,2303,2266,25633499,2261,2.17391304347826
وصنعت,2019-12-23,76109264404,2191,504,4,565,4,17648246,7070000,22484323,2233923,54424228211,21685036193,69207380522,6901883882,2286,2195,2286,2220,24718246,2244,-0.741457124435848
وصنعت,2019-12-24,119678255930,2921,585,8,714,3,29785419,7900000,36674146,1011273,94757359553,24920896377,116491424828,3186831102,2351,2223,2223,2331,37685419,2315,3.15037349788892
وصنعت,2019-12-25,100848331328,2802,761,3,737,4,29387838,1010000,28938242,1459596,97469106789,3379224539,95989807476,4858523852,2484,2333,2430,2443,30397838,2419,4.47103274559194
وصنعت,2019-12-28,53875197214,2388,834,1,619,2,16192359,10000,15745511,456848,53842197214,33000000,52348730334,1526466880,2485,2341,2485,2413,16202359,2424,0.210970464135021
وصنعت,2019-12-29,52832254027,1893,569,4,576,2,15468884,540000,14435579,1573305,51058004027,1774250000,47612330653,5219923374,2441,2342,2406,2426,16008884,2406,-0.75187969924812
وصنعت,2019-12-30,97435994375,2844,1042,2,683,3,27862214,1010000,27243939,1628275,94000511806,3435482569,91918011410,5517982965,2514,2363,2424,2463,28872214,2460,2.27272727272727
وصنعت,2019-12-31,110404435450,3757,1553,1,554,10,32847394,10000,26394791,6462603,110370935450,33500000,88565352616,21839082834,2500,2380,2500,2468,32857394,2449,-0.444444444444444
وصنعت,2020-01-01,51537376668,2161,854,1,467,8,15149025,10000,11426035,3732990,51503776668,33600000,38814325761,12723050907,2513,2443,2478,2445,15159025,2478,1.19047619047619
وصنعت,2020-01-04,4802851730,205,160,1,9,0,1386951,100000,1486951,0,4479851730,323000000,4802851730,0,2355,2355,2355,2355,1486951,2376,-4.11764705882353
وصنعت,2020-01-05,105062178049,2342,763,15,609,1,23620086,10269990,31180901,2709175,73249686079,31812491970,96671863074,8390314975,2303,2258,2258,2258,33890076,2260,-4.9079754601227
وصنعت,2020-01-07,68337581961,2924,1106,5,680,5,19453218,2610000,20795343,1267875,60354891063,7982690898,64565785227,3771796734,2373,2147,2318,2176,22063218,2258,-0.096774193548387
وصنعت,2020-01-08,18380308320,421,187,1,125,0,5954120,100000,6054120,0,18076708320,303600000,18380308320,0,2213,2213,2213,2213,6054120,2213,-1.96964804649661
وصنعت,2020-01-11,1533442608,67,6,0,46,2,495298,0,393498,101800,1533442608,0,1218269808,315172800,2257,2257,2257,2257,495298,2225,0.559947299077734
وصنعت,2020-01-12,9208000255,152,23,0,75,2,2873011,0,2383011,490000,9208000255,0,7637550255,1570450000,2336,2336,2336,2336,2873011,2336,4.97870946609892
وصنعت,2020-01-13,42795392733,967,467,0,305,4,12729554,0,10119554,2610000,42795392733,0,34018280933,8777111800,2453,2406,2453,2453,12729554,2451,4.89859594383775
وصنعت,2020-01-14,100572025605,3186,1207,1,648,7,27788022,1454042,26582929,2659135,95594217847,4977807758,91382053345,9189972260,2564,2458,2529,2554,29242064,2507,2.29030339083879
وصنعت,2020-01-15,73344822692,2527,1128,0,469,4,20837705,0,19797705,1040000,73344822692,0,69694657135,3650165557,2587,2516,2537,2568,20837705,2566,2.35533585344577
وصنعت,2020-01-18,86977983916,3146,1267,3,606,5,23350099,87000,20465414,2971685,86656341916,321642000,75963345806,11014638110,2828,2667,2694,2713,23437099,2705,5.42613636363636
وصنعت,2020-01-19,70163644639,2861,1244,2,658,4,18849949,35000,18042412,842537,70034204639,129440000,67088713287,3074931352,2770,2618,2752,2688,18884949,2708,0.107787658313123
وصنعت,2020-01-20,56369841842,2285,913,2,546,2,15053411,22000,14669960,405451,56289331842,80510000,54861109734,1508732108,2814,2653,2814,2712,15075411,2726,0.646029609690444
وصنعت,2020-01-21,60042671303,2160,829,4,522,3,14877201,1640000,14323800,2193401,54100938427,5941732876,52058824542,7983846761,2712,2608,2712,2625,16517201,2650,-2.78149237764108
وصنعت,2020-01-22,41904896972,1687,769,3,430,2,10920196,560000,10676537,803659,39837325623,2067571349,38964986001,2939910971,2704,2624,2661,2673,11480196,2661,0.412654745529574
وصنعت,2020-01-25,73433107899,2433,961,3,544,5,19491527,525000,12220162,7796365,71496981688,1936126211,44881720126,28551387773,2718,2655,2697,2688,20016527,2675,0.520547945205479
وصنعت,2020-01-26,60811376708,2218,891,2,638,2,16278291,20000,15778291,520000,60737901708,73475000,58889869785,1921506923,2753,2661,2752,2702,16298291,2720,1.68983374216408
وصنعت,2020-01-27,38421238769,1654,642,0,467,1,10537532,0,10337532,200000,38421238769,0,37689238769,732000000,2726,2623,2726,2661,10537532,2658,-2.27820959528277
وصنعت,2020-01-28,41559759057,1915,678,1,593,1,11325747,173025,11398772,100000,40936119282,623639775,41194759057,365000000,2683,2625,2683,2635,11498772,2634,-0.877674163466813
وصنعت,2020-02-01,41204815339,1951,564,1,557,2,11434283,20000,10731283,723000,41132875339,71940000,38583471573,2621343766,2696,2580,2640,2599,11454283,2622,-0.470392916436082
وصنعت,2020-02-02,29412621416,1486,472,0,520,0,8152032,0,8152032,0,29412621416,0,29412621416,0,2674,2572,2573,2640,8152032,2630,0.305810397553517
وصنعت,2020-02-03,61461161358,1322,157,0,596,1,16354898,0,16254898,100000,61461161358,0,61082361358,378800000,2761,2624,2678,2761,16354898,2739,4.15742793791574
وصنعت,2020-02-04,34824992460,555,26,0,333,1,8827628,0,8727628,100000,34824992460,0,34430492460,394500000,2876,2876,2876,2876,8827628,2876,4.97605109100585
وصنعت,2020-02-05,15429666566,372,27,1,288,1,3625173,100000,3625173,100000,15015466566,414200000,15015466566,414200000,3019,3019,3019,3019,3725173,3019,4.9936628643853
وصنعت,2020-02-08,16477799979,376,27,3,276,2,3288871,500000,3651871,137000,14303299979,2174500000,15881986979,595813000,3170,3170,3170,3170,3788871,3170,4.99758570738774
وصنعت,2020-02-09,15266535150,338,32,2,252,2,3013725,329800,3203367,140158,13760668350,1505866800,14626573722,639961428,3328,3328,3328,3328,3343525,3328,4.98965279374569
وصنعت,2020-02-10,492478613212,8764,2393,15,1983,8,100842515,5050242,97653495,8239262,468836251953,23642361259,453540781337,38937831875,3495,3164,3495,3368,105892757,3390,1.86158563293912
وصنعت,2020-02-12,160136339292,4762,1494,7,1268,4,34356229,777271,33881429,1252071,156625426141,3510913151,154423261362,5713077930,3411,3262,3411,3282,35133500,3323,-1.99956998494947
وصنعت,2020-02-15,109677518746,2929,924,4,849,3,24298975,479560,24154535,624000,107553340288,2124178458,106906189954,2771328792,3282,3215,3280,3229,24778535,3226,-2.89600702062308
وصنعت,2020-02-16,73008834242,2486,800,2,641,4,15889957,236943,15051971,1074929,71957516669,1051317573,68159127570,4849706672,3360,3210,3234,3269,16126900,3300,2.28197017623136
وصنعت,2020-02-17,99606856173,3067,1078,5,700,4,21257563,1666133,21823625,1100071,92430948473,7175907700,94793424416,4813431757,3317,3135,3316,3155,22923696,3167,-4.02032250938812
وصنعت,2020-02-18,47115201892,1753,602,5,542,1,9837853,1324594,9662447,1500000,41494571977,5620629915,40916565525,6198636367,3200,3009,3200,3080,11162447,3077,-2.85385500575374
وصنعت,2020-02-19,132860705639,2700,899,1,676,3,29561313,500000,24960313,5101000,130660936893,2199768746,110253073639,22607632000,3231,3087,3171,3231,30061313,3222,4.71452262497039
وصنعت,2020-02-22,73449135664,2264,999,3,507,1,16724473,62274,16427703,359044,73179633524,269502140,71833796708,1615338956,3309,3061,3061,3191,16786747,3189,-1.01809954751131
وصنعت,2020-02-23,121550678749,2720,810,3,734,2,22870587,3853553,19974942,6749198,104155162369,17395516380,91059565993,30491112756,3348,3194,3256,3317,26724140,3315,3.95428571428571
وصنعت,2020-02-24,80460450843,2387,732,10,620,2,12947256,4823214,17615970,154500,58503484453,21956966390,79754748343,705702500,3357,3207,3349,3339,17770470,3301,-0.439753737906772
وصنعت,2020-02-25,205977565060,3452,1005,13,769,8,35948395,7832129,21343396,22437128,169250579891,36726985169,99782302279,106195262781,3465,3339,3339,3465,43780524,3430,3.90901060070671
وصنعت,2020-02-26,90198464986,2679,1017,7,562,4,17422702,1722000,14515054,4629648,82146092631,8052372355,68443255577,21755209409,3535,3353,3535,3354,19144702,3434,0.127523910733262
وصنعت,2020-02-29,97271116903,2463,1004,6,671,4,21104086,599470,19422527,2281029,94583077305,2688039598,87041623829,10229493074,3426,3263,3263,3263,21703556,3267,-4.8609637019741
وصنعت,2020-03-01,303638269956,3670,1022,14,691,6,46036981,18549274,18336255,46250000,216345905861,87292364095,85993003443,217645266513,3430,3259,3259,3430,64586255,3427,4.88621151271754
وصنعت,2020-03-02,310762950093,4779,1637,24,663,2,54359234,11004317,19151551,46212000,258769837727,51993112366,91426974246,219335975847,3554,3400,3554,3506,65363551,3465,1.12741969793661
وصنعت,2020-03-03,567984530224,6185,1721,16,829,10,94850602,20107082,20315035,94642649,468305315091,99679215133,99566970770,468417559454,3638,3499,3572,3638,114957684,3602,3.93352965923433
وصنعت,2020-03-04,659610542980,3993,1301,19,368,7,102951585,24190000,33945322,93196263,534112822980,125497720000,176108330536,483502212444,3782,3782,3782,3782,127141585,3782,4.99898805909735
وصنعت,2020-03-07,798429004722,10243,3233,23,1727,31,125131898,23512811,93436437,55208272,671355997513,127073007209,498664026336,299764978386,3971,3776,3782,3966,148644709,3915,3.52737085582113
وصنعت,2020-03-09,359061321094,6524,3339,7,909,5,69576624,635018,61013806,9197836,355820225599,3241095495,311964323073,47096998021,3915,3720,3720,3720,70211642,3728,-4.78495624650903
وصنعت,2020-03-10,532552925425,9551,3336,10,1568,7,90021799,10667821,63808037,36881583,475832551491,56720373934,336814546862,195738378563,3914,3732,3732,3791,100689620,3855,3.42197888150176
وصنعت,2020-03-16,668989048652,10986,4048,14,1390,19,104700385,15109830,49259477,70550738,585179250673,83809797979,276139109497,392849939155,4341,4003,4213,4009,119810215,4070,5.57761391567404
وصنعت,2020-03-17,421387317409,8867,3407,9,1365,10,67326674,9216648,42287450,34255872,370635838054,50751479355,232876179874,188511137535,4114,3867,4114,4024,76543322,4013,-1.4147564469914
وصنعت,2020-03-18,186727306079,3311,1248,4,729,9,31830996,1050047,24856340,8024703,180796215954,5931090125,141618778143,45108527936,4213,4009,4082,4213,32881043,4140,3.16076294277929
وصنعت,2020-03-24,50348821710,400,51,1,215,3,8344955,100000,3542458,4902497,49752621710,596200000,21120134596,29228687114,4346,4346,4346,4346,8444955,4337,4.77196689558021
وصنعت,2020-03-25,27448018624,299,47,2,200,3,4193792,200000,3353792,1040000,26198618624,1249400000,20951138624,6496880000,4554,4554,4554,4554,4393792,4445,2.48739495798319
وصنعت,2020-03-28,35546791302,411,50,2,250,5,4715936,836515,3386703,2165748,30191422272,5355369030,21681672606,13865118696,4667,4667,4667,4667,5552451,4595,3.37815677271236
وصنعت,2020-03-29,567608096808,8535,4049,6,1342,14,83392692,3327223,67201511,19518404,545896643703,21711453105,440390037752,127218059056,4825,4595,4825,4825,86719915,4771,3.82296954314721
وصنعت,2020-03-30,538410840260,8876,3572,6,1663,11,75391676,4458000,59319676,20530000,508761948732,29648891528,397919006934,140491833326,5009,4606,4782,5009,79849676,4915,3.02521008403361
وصنعت,2020-04-04,513621330201,10037,5093,7,1513,9,71164773,1711695,67175213,5701255,501506146875,12115183326,473583882958,40037447243,5161,5009,5161,5161,72876468,5138,4.52320925404123
وصنعت,2020-04-05,560986728444,13233,5290,16,2394,8,73804318,7694378,78547234,2951462,508105863055,52880865389,540664211937,20322516507,5270,4881,5248,4881,81498696,5017,-2.3410896708286
وصنعت,2020-04-06,571584078528,10171,4228,9,2505,4,82998619,3952000,67550619,19400000,545731450528,25852628000,444372307215,127211771313,4961,4767,4880,4767,86950619,4792,-4.48932151678047
وصنعت,2020-04-07,501258762045,10872,4597,8,1929,11,72313281,2388015,51545496,23155800,485098302411,16160459634,346082622116,155176139929,5030,4775,4775,4826,74701296,4891,2.06875570428963
وصنعت,2020-04-08,476901678676,10537,4016,7,2441,10,68581546,3130989,48134529,23578006,456018554803,20883123873,320176904180,156724774496,4957,4738,4957,4789,71712535,4848,-0.894187779433681
وصنعت,2020-04-11,537235324269,11112,4482,7,1786,11,80477533,2631603,33972936,49136200,520226843892,17008480377,219739157568,317496166701,4839,4664,4811,4710,83109136,4712,-2.79699248120301
وصنعت,2020-04-12,452027986282,4666,1602,2,900,6,66683736,663832,19965876,47381692,447630121954,4397864328,133779300119,318248686163,4947,4775,4810,4947,67347568,4893,3.83663366336634
وصنعت,2020-04-13,997108610211,11436,4957,8,1888,13,140015787,2106935,79833200,62289522,982276233837,14832376374,559067603283,438041006928,5137,4957,5137,5137,142122722,5114,4.52920143027414
وصنعت,2020-04-14,725900523870,10082,3397,7,3091,8,98690391,1069253,47236455,52523189,718052462271,7848061599,340404659000,385495864870,5369,4966,5103,5369,99759644,5304,3.70581527936146
وصنعت,2020-04-15,293395035485,3601,1608,4,1193,4,35276455,3137931,19874198,18540188,269424928125,23970107360,151770639353,141624396132,5568,5504,5568,5568,38414386,5568,4.97526113249038
وصنعت,2020-04-18,55506002409,854,440,0,405,0,6921811,0,6921811,0,55506002409,0,55506002409,0,5845,5845,5845,5845,6921811,5845,4.98821681068343
وصنعت,2020-04-19,617323543517,10204,5304,9,2004,4,74424399,1947957,75573982,798374,601943869222,15379674295,610778230971,6545312546,6137,5554,6137,5613,76372356,5892,0.798104501808205
وصنعت,2020-04-20,761960209616,10795,4875,8,2577,9,87891712,2631000,82313882,8208830,739797266497,22162943119,692297788570,69662421046,6187,5813,5963,6187,90522712,6136,4.13212915996536
وصنعت,2020-04-21,713003798165,14428,6942,8,2716,6,81285827,2755843,81027596,3014074,689797923691,23205874474,687357576871,25646221294,6415,5985,6262,6115,84041670,6184,0.796008078887965
وصنعت,2020-04-22,806966527113,14741,6587,10,3362,6,92255061,2909917,94045535,1119443,782524156723,24442370390,797314744919,9651782194,6400,5942,6195,6302,95164978,6182,-0.047147571900047
وصنعت,2020-04-25,267804959575,4967,2278,3,1763,8,30270505,59117,27749333,2580289,267282460849,522498726,245126886343,22678073232,6491,6270,6415,6491,30329622,6437,4.12735849056604
وصنعت,2020-04-26,871283050040,15347,7448,6,3343,5,95728087,801557,93707341,2822303,864032541400,7250508640,845682871387,25600178653,6758,6123,6758,6584,96529644,6580,2.21970554926387
وصنعت,2020-04-27,627595579348,13293,5938,10,3076,4,63778388,5891481,69464969,204900,574385981663,53209597685,625777513311,1818066037,6758,6342,6582,6466,69669869,6566,-0.199423886549967
وصنعت,2020-04-28,700483623041,15530,6885,12,3796,8,74047474,6176748,79363022,861200,646664314898,53819308143,693013359771,7470263270,6582,6288,6582,6323,80224222,6365,-3.0639431616341
وصنعت,2020-04-29,315723309257,6193,2630,4,2353,5,34108486,706900,33819832,995554,309279891386,6443417871,306687558781,9035750476,6683,6393,6488,6683,34815386,6610,3.84791571232249
وصنعت,2020-05-02,45426776099,826,181,1,599,1,4740996,30223,4766219,5000,45139022916,287753183,45379171099,47605000,6940,6940,6940,6940,4771219,6896,4.3228936921041
وصنعت,2020-05-03,96997528836,1308,552,1,554,3,9281711,27749,8704460,605000,96708134515,289394321,90690463836,6307065000,7602,7241,7241,7602,9309460,7595,10.1374207188161
وصنعت,2020-05-04,767153992674,9727,5318,3,2318,2,69671373,1078876,70245249,505000,755614674252,11539318422,761837553210,5316439464,7974,7602,7974,7974,70750249,7904,4.06948843459065
وصنعت,2020-05-05,1044647858283,15214,8130,12,3211,8,90929793,4165780,92728395,2367178,998534668051,46113190232,1018435898048,26211960235,8299,7509,8299,7691,95095573,8008,1.30960066402287
وصنعت,2020-05-06,682972142954,12419,5818,2,3254,5,61044271,202000,55884271,5362000,680809589375,2162553579,621901915992,61070226962,8408,7639,7727,8408,61246271,8129,1.51115157032317
وصنعت,2020-05-09,78977765792,1431,692,0,660,1,6745624,0,6743624,2000,78977765792,0,78954349792,23416000,8535,8535,8535,8535,6745624,8535,4.99506770693211
وصنعت,2020-05-10,448681658493,5940,3598,5,1321,5,36548605,51152,32489739,4110018,448052852777,628805716,398157217137,50524441356,8961,8638,8961,8961,36599757,8936,4.70618380594465
وصنعت,2020-05-11,706166678048,10646,6114,3,2452,5,54951996,46800,53856544,1142252,705564316048,602362000,691486380828,14680297220,9382,9160,9382,9382,54998796,9360,4.73937515294885
وصنعت,2020-05-12,178686905441,3783,2879,3,467,0,14016862,436400,14453262,0,173363347741,5323557700,178686905441,0,9403,8892,9403,8892,14453262,9012,-3.71495327102804
وصنعت,2020-05-13,741571044783,10818,4886,5,3666,9,60882267,627366,57544397,3965236,733933013776,7638031007,694327279323,47243765460,9352,8562,8562,8562,61509633,8788,-2.48321604788482
وصنعت,2020-05-16,81502608791,1619,990,1,522,0,7080355,17000,7097355,0,81307890791,194718000,81502608791,0,8427,8349,8398,8349,7097355,8371,-4.74452554744526
وصنعت,2020-05-17,61537331320,1170,837,3,188,0,5626452,14000,5640452,0,61384591320,152740000,61537331320,0,7953,7953,7953,7953,5640452,7953,-4.99825844653431
وصنعت,2020-05-18,651359344170,11103,4183,2,3930,5,59179694,221970,57381664,2020000,648950068170,2409276000,629143916269,22215427901,8338,7581,7954,7959,59401664,7993,0.504124656278643
وصنعت,2020-05-19,369582028651,7186,3702,2,1746,3,33754743,1210000,32884103,2080640,356774133737,12807894914,347809334489,21772694162,8157,7594,8157,7594,34964743,7705,-3.60237118103055
وصنعت,2020-05-20,734915047754,15179,5544,8,5485,5,70236715,1173000,70673653,736062,723009858163,11905189591,727160344684,7754703070,8009,7320,7654,7654,71409715,7502,-2.63008514664144
وصنعت,2020-05-23,469081577612,8593,3535,6,2721,9,44614839,2609728,46684314,540253,443472200674,25609376938,463643842544,5437735068,7683,7128,7683,7180,47224567,7241,-3.48814613291877
وصنعت,2020-05-26,214598000000,3733,1519,2,1547,0,21981290,550500,22531790,0,209389333102,5208924771,214598257873,0,7247,6885,6931,6885,22531790,6949,-4.03063280935107
وصنعت,2020-05-27,304186024784,7283,2833,5,2866,3,30918855,486000,30890441,514414,299654695670,4531329114,299075694619,5110330165,7296,6602,6602,7296,31404855,7067,1.70096598068039
وصنعت,2020-05-30,72211434120,1577,989,0,517,3,7100436,0,4770088,2330348,72211434120,0,48511794960,23699639160,7420,7420,7420,7420,7100436,7420,4.99690274623167
وصنعت,2020-05-31,520312072657,8757,4083,5,2476,5,49540843,273700,46931593,2882950,517545277657,2766795000,489968663181,30343409476,7791,7087,7791,7748,49814543,7621,2.70403146509341
وصنعت,2020-06-01,222760288425,5430,2618,3,1542,2,20828426,41000,20239426,630000,222317192855,443095570,216024532168,6735756257,7953,7369,7662,7770,20869426,7788,2.19243657252274
وصنعت,2020-06-02,238806096350,6040,2910,1,1857,6,21744421,10000,21400284,354137,238696036350,110060000,234909533299,3896563051,8099,7588,7843,8091,21754421,8009,2.83867341202923
وصنعت,2020-06-06,346142244039,6047,2633,6,2063,4,20882974,9473832,24974172,5382634,237607974801,108534269238,284463567589,61678676450,8409,8010,8318,8409,30356806,8319,3.87173180286053
وصنعت,2020-06-07,337586648412,5919,3343,6,1577,4,26813151,1395000,25658151,2550000,320893337544,16693310868,307089313443,30497334969,8735,8646,8735,8698,28208151,8732,4.96404139624627
وصنعت,2020-06-08,339458261054,6061,3017,4,1792,0,26408241,2730369,29138610,0,307490409359,31967851695,339458261054,0,9168,8296,9168,8296,29138610,8500,-2.65708556149733
وصنعت,2020-06-09,287500210518,4534,2038,5,1592,5,25204204,657352,24747962,1113594,280197822160,7302388358,275162353131,12337857387,8499,8075,8493,8075,25861556,8111,-4.57510729613734
وصنعت,2020-06-10,454422417370,7941,2891,9,2798,8,39136969,1901659,40039070,999558,433470288608,20952128762,443436916956,10985500414,8360,7880,7880,8139,41038628,8079,-0.395790231177476
وصنعت,2020-06-13,336783303890,6424,2833,5,2025,4,28517460,1139997,28850207,807250,323849176230,12934127660,327512401920,9270901970,8427,8157,8361,8259,29657457,8288,2.59189018332882
وصنعت,2020-06-14,513444377680,8914,3782,8,3088,4,39963288,7075807,45831095,1208000,436356365430,77088012250,500241633190,13202744490,8383,7880,8383,7982,47039095,7967,-3.87323943661972
وصنعت,2020-06-15,89748634740,1414,98,2,1150,3,6941469,890000,6449192,1382277,79549234740,10199400000,73907740320,15840894420,8361,8361,8361,8361,7831469,8361,4.94505494505495
وصنعت,2020-06-16,78959795220,1077,83,1,881,1,6463574,100000,4563574,2000000,77756795220,1203000000,54899795220,24060000000,8777,8777,8777,8777,6563574,8777,4.9738219895288
وصنعت,2020-06-20,48544213320,1050,72,0,920,0,3843564,0,3843564,0,48544213320,0,48544213320,0,9215,9215,9215,9215,3843564,9179,4.57190357439734
وصنعت,2020-06-21,81337726800,1049,103,1,850,1,6061949,100000,5661949,500000,80017726800,1320000000,74737726800,6600000000,9631,9631,9631,9631,6161949,9631,4.92845786963434
وصنعت,2020-06-22,102506966100,915,119,2,710,1,7195885,200000,5395885,2000000,99734966100,2772000000,74786966100,27720000000,10112,10112,10112,10112,7395885,10112,5
وصنعت,2020-06-23,80847875250,935,123,1,777,1,5456555,100000,5356555,200000,79392875250,1455000000,77937875250,2910000000,10616,10616,10616,10616,5556555,10616,4.97835497835498
وصنعت,2020-06-24,851964101580,6013,2871,5,1747,7,55575896,233000,41423377,14385519,848406191580,3557910000,632303226450,219660875130,11141,10959,11141,11141,55808896,11141,4.94845360824742
وصنعت,2020-07-01,768179256380,7212,3621,1,1665,4,50673284,90000,48121595,2641689,766799156380,1380100000,728740611920,39438644460,15374,14235,14907,14381,50763284,14722,32.1397379912664
وصنعت,2020-07-04,375440768760,7045,5461,4,884,5,25599690,467500,25177191,889999,368718118760,6722650000,362630583240,12810185520,14089,13992,14089,13992,26067190,14012,-4.82485128883014
وصنعت,2020-07-05,1610601940780,19977,8732,7,7057,8,112373620,425322,104102660,8696282,1604559767220,6042173560,1483555066980,127046873800,14712,13311,13311,14265,112798942,13895,-0.833333333333333
وصنعت,2020-07-06,660927244300,9106,4296,4,3264,3,42491723,1745337,43887060,350000,634764642670,26162601630,655697544300,5229700000,14586,14245,14450,14586,44237060,14537,4.6218487394958
وصنعت,2020-07-07,1027398903390,17266,9587,12,3922,10,69111647,2514178,69526100,2099725,991160134650,36238768740,997489925600,29908977790,14673,13817,14673,13817,71625825,13953,-4.01606425702811
وصنعت,2020-07-08,339940225080,6755,4214,3,1661,1,24780101,26500,24786601,20000,339578365080,361860000,339667025080,273200000,13817,13262,13720,13262,24806601,13331,-4.46304044630405
وصنعت,2020-07-11,543888729160,8729,4102,3,3212,2,40124582,920000,40974582,70000,531656788360,12231940800,542967576660,921152500,13613,12669,12669,12932,41044582,12893,-3.28467153284672
وصنعت,2020-07-12,621140759500,9804,4920,1,3031,2,45425816,80000,44986816,519000,620087216380,1053543120,613927869500,7212890000,13535,12649,13457,12776,45505816,13282,3.0188679245283
وصنعت,2020-07-13,492522916130,8905,4491,6,2948,7,37117561,669000,37453375,333186,483839826130,8683090000,488165382570,4357533560,13107,12620,12698,12620,37786561,12679,-4.54212454212454
وصنعت,2020-07-14,648370754330,12667,5768,6,4167,2,51000415,295900,50797129,499186,644593342330,3777412000,642065613090,6305141240,12990,12046,12552,12046,51296315,12299,-2.99309286262471
وصنعت,2020-07-15,624117192340,13690,6183,1,4759,3,49903077,1000000,49647824,1255253,611760608500,12356583840,608901237060,15215955280,12406,11686,11968,11881,50903077,11929,-3.00632911392405
وصنعت,2020-07-18,271487752530,5429,2333,0,2297,4,21204799,0,20757986,446813,271487752530,0,265740569220,5747183310,12523,12163,12396,12523,21204799,12455,4.40456769983687
وصنعت,2020-07-19,150561344640,2379,1060,0,1094,4,11202481,0,10195753,1006728,150561344640,0,137030920320,13530424320,13078,13078,13078,13078,11202481,13078,5
وصنعت,2020-07-20,966679463690,16279,9609,5,3640,10,68732154,159783,65052221,3839716,964435251780,2244211910,912531128760,54148334930,13729,13087,13729,13399,68891937,13652,4.38988095238095
وصنعت,2020-07-21,436596107660,8790,4942,9,2382,2,31756225,808364,31994589,570000,425776128290,10819979370,428907507660,7688600000,13525,12971,13331,12971,32564589,13048,-4.41910192444761
وصنعت,2020-07-22,463539739460,9555,4349,10,3388,1,36086803,226479,35813282,500000,460653288000,2886451460,457169739460,6370000000,12941,12396,12649,12426,36313282,12426,-4.77255779269202
وصنعت,2020-07-25,339396773660,5702,1916,2,3000,5,25381275,4335,23179330,2206280,339338771360,58002300,309832810060,29563963600,13039,12610,12610,13039,25385610,13009,4.69851213782302
وصنعت,2020-07-26,391659702630,8346,4226,5,2702,3,29328930,592500,29529846,391584,384015912630,7643790000,386580300820,5079401810,13447,12377,13447,12494,29921430,12737,-2.09424083769633
وصنعت,2020-07-27,559573817820,9312,4147,10,3596,3,43290611,1622311,44613047,299875,539381361860,20192455960,555843372820,3730445000,12338,12105,12212,12105,44912922,12124,-4.81283422459893
وصنعت,2020-07-28,711963806960,12891,4646,5,5214,7,56379356,508000,56008152,879204,705540116960,6423690000,700993453530,10970353430,12698,11725,12095,12085,56887356,12182,0.481540930979133
وصنعت,2020-07-29,855143370360,13872,4422,6,5943,11,67248305,377700,65424355,2201650,850447389860,4695980500,827637053870,27506316490,12786,11686,12182,12786,67626005,12309,1.03833865814697
وصنعت,2020-08-01,92152576000,1681,264,0,1244,4,6939200,0,6694941,244259,92152576000,0,88908816480,3243759520,12922,12922,12922,12922,6939200,12922,4.9802371541502
وصنعت,2020-08-02,693191693720,8574,4716,2,2353,2,49918189,30000,49391190,556999,692773993720,417700000,685442257660,7749436060,13564,13155,13564,13554,49948189,13506,4.51807228915663
وصنعت,2020-08-03,590003735790,10298,4514,5,3742,5,41796138,1958000,43451474,302664,563844183570,26159552220,585915625250,4088110540,13613,12854,13408,13262,43754138,13116,-2.88184438040346
وصنعت,2020-08-04,744261798300,11315,3852,4,5355,8,45362694,8026100,53025030,363764,630724902010,113536896290,739194725120,5067073180,13768,13233,13331,13768,53388794,13564,3.41246290801187
وصنعت,2020-08-05,659566488930,10760,4521,8,4282,1,44491009,931010,45368019,54000,646010673760,13555815170,658776468930,790020000,14235,13671,14148,14158,45422019,14128,4.16068866571019
وصنعت,2020-08-09,1146953725450,15660,6079,6,5561,6,80208307,412000,80439333,180974,1141215433800,5738291650,1144335641150,2618084300,14401,13428,14304,13720,80620307,13846,-1.99724517906336
وصنعت,2020-08-10,340141311590,4918,2438,3,1831,2,24898148,135666,24667148,366666,338307020650,1834290940,335183987270,4957324320,13622,13155,13428,13155,25033814,13223,-4.4975404075896
وصنعت,2020-08-11,103755196960,1547,860,3,527,0,7964889,65699,8030588,0,102906365880,848831080,103755196960,0,12572,12572,12572,12572,8030588,12572,-4.93009565857248
وصنعت,2020-08-12,690318818460,7707,2430,4,3474,3,52094957,552834,52206125,441666,683321063930,6997754530,684700076780,5618741680,13194,12075,13068,12416,52647791,12756,1.47058823529412
وصنعت,2020-08-15,425470534440,4765,1642,5,2191,6,33604702,155633,33111455,648880,423510714150,1959820290,417280723760,8189810680,12766,12124,12377,12212,33760335,12260,-3.89016018306636
وصنعت,2020-08-16,426809066190,7066,2780,6,2665,1,31658855,3680334,35335298,3891,382751718210,44057347980,426762490920,46575270,12640,11647,11968,11647,35339189,11754,-4.12698412698413
وصنعت,2020-08-17,452236563050,7055,2586,4,2692,6,36106229,9536,33550528,2565237,452115886090,120676960,419733310430,32503252620,12338,11491,11491,12319,36115765,12182,3.64238410596027
وصنعت,2020-08-18,393971928180,6164,2878,3,2006,5,30327796,11111,29872193,466714,393827019840,144908340,388023429980,5948498200,12786,12182,12718,12319,30338907,12640,3.75399361022364
وصنعت,2020-08-19,64036259100,1060,758,3,200,0,4817014,365681,5182695,0,59520098750,4516160350,64036259100,0,12163,12017,12017,12017,5182695,12027,-4.84988452655889
وصنعت,2020-08-22,230980457080,3760,1540,4,1524,0,19429135,45000,19474135,0,230434707080,545750000,230980457080,0,12552,11433,12027,11433,19474135,11540,-4.0453074433657
وصنعت,2020-08-23,54200732110,769,470,1,224,0,3809293,1000000,4809293,0,42930732110,11270000000,54200732110,0,10966,10966,10966,10966,4809293,10966,-4.97470489038786
وصنعت,2020-08-24,1182024952550,9303,2652,6,3581,1,110011570,121810,110086714,46666,1180711361470,1313591080,1181524693030,500259520,10801,10421,10421,10421,110133380,10441,-4.79148181011535
وصنعت,2020-08-25,292392659880,2723,1042,1,1198,1,25967932,10000,25627932,350000,292280059880,112600000,288451659880,3941000000,10956,10703,10956,10956,25977932,10956,4.93942218080149
وصنعت,2020-08-26,32818478220,555,63,0,460,1,2776521,0,2759855,16666,32818478220,0,32621486100,196992120,11501,11501,11501,11501,2776521,11326,3.37477797513321
وصنعت,2020-08-31,710822349570,8168,3716,12,2256,4,61031571,1020295,60316342,1735524,699479771520,11342578050,689624371420,21197978150,11890,10762,11890,10898,62051866,11151,-1.54639175257732
وصنعت,2020-09-01,85247152010,1620,863,6,578,0,7375447,425543,7800990,0,80611988740,4635163270,85247152010,0,10878,10596,10752,10596,7800990,10635,-4.62478184991274
وصنعت,2020-09-02,19660176190,503,400,3,61,0,1880221,12000,1892221,0,19535496190,124680000,19660176190,0,10110,10110,10110,10110,1892221,10402,-2.19579139981702
وصنعت,2020-09-05,419398610490,6215,2163,6,2489,3,39693146,1034563,33710375,7017334,408723766750,10674843740,348092181140,71306429350,10801,9886,10129,10265,40727709,10022,-3.64826941066417
وصنعت,2020-09-06,180557424300,3575,1713,7,974,2,17787751,181795,17911807,57739,178776455640,1780968660,179948214240,609210060,10402,9526,10217,9526,17969546,9779,-2.42718446601942
وصنعت,2020-09-07,8021885400,314,263,1,24,0,838988,1000,839988,0,8012335400,9550000,8021885400,0,9292,9292,9292,9292,839988,9691,-0.895522388059701
وصنعت,2020-09-08,5421953800,190,165,0,7,0,572540,0,572540,0,5421953800,0,5421953800,0,9215,9215,9215,9215,572540,9633,-0.602409638554217
وصنعت,2020-09-09,400371518330,6993,2459,2,2883,3,42276207,1600,42138166,139641,400356190330,15328000,399056802040,1314716290,9536,9156,9156,9477,42277807,9215,-4.34343434343434
وصنعت,2020-09-12,372585879650,3074,780,0,1567,2,37526757,0,37104175,422582,372585879650,0,368385414570,4200465080,9672,9244,9662,9672,37526757,9662,4.85744456177402
وصنعت,2020-09-13,274149228580,5049,1987,3,1702,2,27508475,750000,28256142,2333,266879452710,7269775870,274126535080,22693500,9974,9185,9730,9351,28258475,9438,-2.31621349446123
وصنعت,2020-09-14,285046738930,4338,1254,2,2071,4,28181937,310378,26015882,2476433,281955582080,3091156850,259841384320,25205354610,9905,9244,9244,9905,28492315,9730,3.09278350515464
وصنعت,2020-09-15,210513823370,2632,1214,1,945,3,20130047,3400,19677047,456400,210478157370,35666000,205727223370,4786600000,10217,9905,10032,10217,20133447,10178,4.6
وصنعت,2020-09-16,333092368640,6278,2566,3,2510,1,30741344,15200,30754544,2000,332932473820,159894820,333070668640,21700000,10684,10178,10684,10373,30756544,10538,3.53728489483748
وصنعت,2020-09-19,200598498090,4376,1662,3,1901,2,18879589,440490,19269329,50750,196056155990,4542342100,200074780590,523717500,10402,10012,10295,10012,19320079,10100,-4.15512465373961
وصنعت,2020-09-20,77173563470,1698,727,2,737,0,7493983,300510,7794493,0,74204529770,2969033700,77173563470,0,9828,9604,9672,9604,7794493,9633,-4.6242774566474
وصنعت,2020-09-21,200613498130,2894,840,3,1420,2,13714324,7422732,21054556,82500,129650104310,70963393820,199781973130,831525000,10032,9156,9156,9263,21137056,9234,-4.14141414141414
وصنعت,2020-09-22,194180146110,4091,1423,4,1632,1,20697713,185731,20878444,5000,192423882570,1756263540,194134346110,45800000,9633,8806,9341,9156,20883444,9049,-2.00210748155954
وصنعت,2020-09-23,190314310450,3982,1637,4,1450,0,19702404,680530,20382934,0,183811406470,6502903980,190314310450,0,9448,8670,9244,9030,20382934,9088,0.430107526881721
وصنعت,2020-09-26,159478335690,2972,1599,2,723,0,17692112,1666,17693778,0,159463541610,14794080,159478335690,0,9234,8641,9039,8641,17693778,8767,-3.53319057815846
وصنعت,2020-09-27,61824261250,886,452,1,406,0,7206922,15000,7221922,0,61695861250,128400000,61824261250,0,8368,8329,8329,8329,7221922,8329,-4.99445061043285
وصنعت,2020-09-28,8946120480,256,222,1,16,0,1094032,5000,1099032,0,8905420480,40700000,8946120480,0,7920,7920,7920,7920,1099032,8242,-1.05140186915888
وصنعت,2020-09-29,256864250280,3992,1427,3,1750,2,31624083,137376,31759459,2000,255757373480,1106876800,256847990280,16260000,8349,7833,7833,7989,31761459,7872,-4.48642266824085
وصنعت,2020-09-30,209384689140,4014,1319,3,1611,3,25816098,70600,24696698,1190000,208807063870,577625270,199615269740,9769419400,8349,7483,7891,8086,25886698,7872,0
وصنعت,2020-10-03,97931799930,1606,574,0,803,2,11576833,0,11304167,272666,97931799930,0,95617665590,2314134340,8261,7979,8173,8261,11576833,8232,4.57354758961681
وصنعت,2020-10-05,104081267850,2658,937,1,1086,5,12113812,1193,11224610,890395,104070805240,10462610,96325709160,7755558690,8563,8028,8076,8533,12115005,8358,0.116550116550117
وصنعت,2020-10-06,77986939710,1255,386,1,694,2,8665688,3000,7964855,703833,77959939710,27000000,71645404380,6341535330,8767,8563,8748,8767,8668688,8757,4.77299185098952
وصنعت,2020-10-07,225838200310,4122,2022,1,1263,6,24052443,1000,22000476,2052967,225828760310,9440000,206465337410,19372862900,9195,8679,9195,9195,24053443,9137,4.33333333333333
وصنعت,2020-10-10,145595202450,3317,1595,6,1077,2,15317614,120540,15235154,203000,144467793100,1127409350,143648561630,1946640820,9419,8806,9331,9224,15438154,9176,0.425985090521832
وصنعت,2020-10-11,204615940770,4425,2117,3,1287,7,20823357,379188,19130766,2071779,201002953730,3612987040,184412886690,20203054080,9614,9078,9331,9146,21202545,9390,2.33297985153765
وصنعت,2020-10-12,195483379190,3460,1393,3,1353,2,18515474,2646000,21001474,160000,171179403940,24303975250,194016179190,1467200000,9244,8923,9059,8942,21161474,8991,-4.24870466321244
وصنعت,2020-10-13,119966539040,3018,1283,2,1131,1,12705785,783400,13488186,999,113010117040,6956422000,119957757830,8781210,9117,8543,9010,8660,13489185,8650,-3.78787878787879
وصنعت,2020-10-14,148604962620,2684,844,2,1151,4,16155148,955889,16038004,1073033,140424709680,8180252940,139117441920,9487520700,8796,8232,8563,8660,17111037,8446,-2.36220472440945
وصنعت,2020-10-18,228466070940,2890,911,3,1191,6,26762157,68014,19948731,6881440,227884194000,581876940,169799627020,58666443920,8757,8096,8125,8222,26830171,8290,-1.84331797235023
وصنعت,2020-10-19,100538940770,1838,787,2,604,11,9627832,2750000,10420774,1957058,78260928190,22278012580,84686770970,15852169800,8173,7882,8037,7882,12377832,7901,-4.69483568075117
وصنعت,2020-10-20,174163464260,3340,1304,4,1214,5,21028829,1372107,20084015,2316921,163557559710,10605904550,156189130450,17974333810,7823,7512,7512,7677,22400936,7560,-4.31034482758621
وصنعت,2020-10-21,229965956300,3107,1038,2,1373,4,28285393,31000,25467856,2848537,229716195800,249760500,206808947550,23157008750,7930,7590,7930,7930,28316393,7901,4.50450450450451
وصنعت,2020-10-24,174260389220,3041,956,3,1248,3,21475449,309660,21721523,63586,171802729400,2457659820,173748326440,512062780,8164,7560,7998,7570,21785109,7784,-1.47783251231527
وصنعت,2020-10-26,159285367390,2921,772,3,1362,2,20112197,147000,20114197,145000,158140447390,1144920000,158131017390,1154350000,7804,7414,7414,7638,20259197,7648,-1.75
وصنعت,2020-10-27,122735365830,1969,885,1,612,1,13625336,2600000,16220606,4730,103246982990,19488382840,122698992130,36373700,7775,7269,7677,7269,16225336,7356,-3.81679389312977
وصنعت,2020-10-28,132981949810,2640,1141,4,883,1,16584024,1630491,17121044,1093471,121245789360,11736160450,124832927050,8149022760,7775,6996,7006,7259,18214515,7103,-3.43915343915344
وصنعت,2020-10-31,128349345510,2127,860,3,838,4,16834740,14033,14231872,2616901,128243775770,105569740,108360861690,19988483820,7453,7123,7123,7453,16848773,7414,4.38356164383562
وصنعت,2020-11-01,105296699010,1807,630,3,666,2,13084674,831000,13663111,252563,99018509010,6278190000,103366505060,1930193950,7629,7123,7629,7269,13915674,7366,-0.656167979002625
وصنعت,2020-11-02,74406604330,1484,638,1,527,1,10099271,71653,10135458,35466,73889986200,516618130,74148766510,257837820,7337,7016,7025,7181,10170924,7123,-3.30250990752972
وصنعت,2020-11-04,108167641510,1581,452,1,753,2,14102388,50000,11547388,2605000,107787241510,380400000,88201144260,19966497250,7473,7025,7288,7473,14152388,7434,4.37158469945355
وصنعت,2020-11-07,41777198100,540,417,3,38,0,3151074,2603361,5754435,0,22876797240,18900400860,41777198100,0,7064,7064,7064,7064,5754435,7113,-4.31937172774869
وصنعت,2020-11-08,44291856550,356,241,4,33,0,1769629,4603300,6372929,0,12298921550,31992935000,44291856550,0,6763,6763,6763,6763,6372929,6772,-4.78796169630643
وصنعت,2020-11-09,164531398990,2491,917,4,953,1,22032682,2636000,24641682,27000,147044078990,17487320000,164352658990,178740000,6724,6441,6578,6510,24668682,6490,-4.16666666666667
وصنعت,2020-11-10,118699046500,1071,127,1,697,12,16914151,50000,14061099,2903052,118349046500,350000000,98377682500,20321364000,6811,6519,6519,6811,16964151,6811,4.94752623688156
وصنعت,2020-11-15,316404965250,4699,2131,5,1183,6,40000123,485509,37528055,2957577,312715312120,3689653130,292728240720,23676724530,7804,7200,7804,7395,40485632,7609,2.35602094240838
وصنعت,2020-11-16,136404126100,3059,1194,3,1023,4,17193662,136000,15236662,2093000,135335536100,1068590000,119839811590,16564314510,7872,7230,7288,7570,17329662,7658,0.639386189258312
وصنعت,2020-11-17,146788250100,2972,1287,1,920,3,18020486,283422,17067218,1236690,144538453180,2249796920,136854945460,9933304640,7950,7395,7775,7872,18303908,7804,1.90597204574333
وصنعت,2020-11-18,146169725470,3241,1543,2,1030,1,17620212,150000,17766082,4130,144946692350,1223033120,146136396370,33329100,8154,7823,7901,8135,17770212,8008,2.61845386533666
وصنعت,2020-11-21,200556750770,4071,1597,2,1341,1,22619108,2472000,25086108,5000,181058890770,19497860000,200516350770,40400000,8251,7609,8251,7609,25091108,7775,-2.91616038882139
وصنعت,2020-11-22,97171912960,2165,871,4,858,2,11267743,1260713,12368772,159684,87524785450,9647127510,95909293560,1262619400,7872,7395,7590,7648,12528456,7551,-2.87859824780976
وصنعت,2020-11-23,79926759320,2075,803,4,830,2,9967134,178512,9977047,168599,78535424520,1391334800,78585663180,1341096140,7843,7424,7648,7726,10145646,7667,1.54639175257732
وصنعت,2020-11-24,130146780670,2702,981,1,1006,2,16062171,370577,16378661,54087,127220910830,2925869840,129726597720,420182950,7911,7405,7609,7551,16432748,7706,0.507614213197969
وصنعت,2020-11-25,131201307270,2731,1079,4,950,3,16196544,591662,16608604,179602,126593569450,4607737820,129788841370,1412465900,7765,7405,7453,7648,16788206,7609,-1.26262626262626
وصنعت,2020-11-28,193576170690,3668,1429,4,1263,2,24304301,163792,23648093,820000,192275809550,1300361140,187126470690,6449700000,7930,7405,7473,7901,24468093,7697,1.15089514066496
وصنعت,2020-11-29,112277389940,1538,604,0,680,2,13535742,0,10895742,2640000,112277389940,0,90366689940,21910700000,8076,7950,8066,8076,13535742,8066,4.80404551201011
وصنعت,2020-11-30,63620994600,811,209,0,517,2,7312758,0,5556743,1756015,63620994600,0,48343664100,15277330500,8465,8465,8465,8465,7312758,8465,4.94571773220748
وصنعت,2020-12-01,529690220430,7347,2917,4,2390,3,58013551,548210,55788428,2773333,524794172330,4896048100,504454972700,25235247730,8884,8105,8709,8884,58561761,8796,3.90804597701149
وصنعت,2020-12-02,269171096970,4898,2042,1,1513,1,28553426,635643,28823370,365699,263396248990,5774847980,265839248510,3331848460,9176,8660,8952,8942,29189069,8971,1.99115044247788
وصنعت,2020-12-05,297792093060,5463,2209,3,1507,2,31906995,560313,32335544,131764,292663718870,5128374190,296566553450,1225539610,9098,8767,8767,8913,32467308,8923,-0.542299349240781
وصنعت,2020-12-06,470181391320,6989,2783,3,2095,2,50186462,527000,50312907,400555,465305491240,4875900080,466456252020,3725139300,9127,8894,8952,9039,50713462,9020,1.09051254089422
وصنعت,2020-12-09,277928467210,3459,1517,2,1036,1,31224447,633334,31822781,35000,272392128110,5536339100,277620467210,308000000,9140,8520,8960,8630,31857781,8720,-3.32594235033259
وصنعت,2020-12-12,562663680520,9783,4074,3,2867,2,64003445,2855000,66741235,117210,538869920520,23793760000,561669943160,993737360,8780,8290,8690,8290,66858445,8420,-3.44036697247706
وصنعت,2020-12-13,295524518290,5896,2521,2,1869,0,35763694,678533,36442227,0,290021531140,5502987150,295524518290,0,8400,8020,8200,8050,36442227,8110,-3.68171021377672
وصنعت,2020-12-14,256068813010,5433,2142,6,1972,2,30397480,1448647,31516127,330000,244302548960,11766264050,253421134110,2647678900,8400,7750,8000,7790,31846127,8040,-0.863131935881628
وصنعت,2020-12-15,92173741300,1628,788,2,579,0,9414328,2602000,12016328,0,72277561300,19896180000,92173741300,0,8040,7640,7750,7640,12016328,7670,-4.60199004975124
وصنعت,2020-12-16,302693562710,5172,2425,6,1504,1,39770685,1609225,41249910,130000,290932106950,11761455760,301714662710,978900000,7620,7290,7290,7320,41379910,7310,-4.69361147327249
وصنعت,2020-12-19,182746114270,2934,1082,7,1184,7,23589015,506649,20996664,3099000,178987360060,3758754210,159155149330,23590964940,7670,7320,7320,7670,24095664,7580,3.69357045143639
وصنعت,2020-12-20,281711560330,5107,2080,5,1585,3,34866602,1207405,34947887,1126120,272399574340,9311985990,272761965050,8949595280,7950,7580,7950,7750,36074007,7810,3.03430079155673
وصنعت,2020-12-21,180184315410,3982,1565,4,1286,2,22710819,834174,23383650,161343,173863834630,6320480780,178932294100,1252021310,7890,7420,7890,7530,23544993,7650,-2.04865556978233
وصنعت,2020-12-22,208598625970,3975,1592,4,1344,3,26418434,725643,26731077,413000,203108039130,5490586840,205417935970,3180690000,7890,7440,7530,7760,27144077,7680,0.392156862745098
وصنعت,2020-12-23,218883596040,4288,1833,6,1355,5,27505022,572988,24476275,3601735,214463328680,4420267360,190937095090,27946500950,7980,7600,7800,7820,28078010,7800,1.5625
وصنعت,2020-12-26,216613079200,5104,2094,5,1740,3,26791450,853220,27543828,100842,209966910970,6646168230,215814323920,798755280,7970,7690,7970,7740,27644670,7840,0.512820512820513
وصنعت,2020-12-27,225014430590,4675,1979,8,1560,2,27189713,2713916,29329332,574297,204647407770,20367022820,220650297830,4364132760,7730,7450,7550,7570,29903629,7520,-4.08163265306122
وصنعت,2020-12-28,145588814440,3497,1346,6,1274,7,18274410,1303885,19089911,488384,135886623150,9702191290,141911909800,3676904640,7630,7320,7630,7430,19578295,7440,-1.06382978723404
وصنعت,2020-12-29,173380710330,3464,1355,7,1236,3,16907184,7239225,22521883,1624526,121447707400,51933002930,161771271630,11609438700,7500,7090,7450,7160,24146409,7180,-3.49462365591398
وصنعت,2020-12-30,158037087630,3654,1341,8,1428,4,19741141,2787272,22336518,191895,138597547550,19439540080,156678515670,1358571960,7180,6880,7090,6950,22528413,7020,-2.22841225626741
وصنعت,2021-01-02,174970393860,3522,1629,5,1241,2,23199151,2918546,25987597,130100,155470032040,19500361820,174077925860,892468000,6950,6670,6860,6690,26117697,6700,-4.55840455840456
وصنعت,2021-01-03,171090010590,3849,1480,1,1447,4,24200377,746859,22597227,2350009,166008755020,5081255570,154751081100,16338929490,7030,6490,6520,7030,24947236,6860,2.38805970149254
وصنعت,2021-01-04,149979198240,2388,1099,1,880,3,20824800,30000,18048800,2806000,149763198240,216000000,129779178260,20200019980,7200,6990,7200,7200,20854800,7190,4.81049562682216
وصنعت,2021-01-05,170429646010,3819,1431,4,1380,2,22129667,1808598,23523265,415000,157579816090,12849829920,167428432030,3001213980,7370,6980,7350,7020,23938265,7120,-0.973574408901252
وصنعت,2021-01-06,139004998900,2989,1214,2,1169,0,18466583,2000000,20466583,0,125429898900,13575100000,139004998900,0,7100,6770,7040,6790,20466583,6790,-4.63483146067416
وصنعت,2021-01-09,121419450060,3004,997,1,1239,1,17514748,488842,17743590,260000,118136639850,3282810210,119660550060,1758900000,6950,6560,6750,6830,18003590,6740,-0.736377025036819
وصنعت,2021-01-10,143283752000,2386,817,3,991,3,18207455,2086268,17588723,2705000,128534031070,14749720930,124164242000,19119510000,7070,6950,6970,7070,20293723,7060,4.74777448071217
وصنعت,2021-01-11,139612458240,3271,1338,6,1055,2,17373358,3052464,20258822,167000,118978195510,20634262730,138441360140,1171098100,7250,6720,7090,6760,20425822,6840,-3.11614730878187
وصنعت,2021-01-12,161718151940,2726,881,6,1212,3,14046691,10703524,24390579,359636,91883643150,69834508790,159367808640,2350343300,6710,6500,6710,6520,24750215,6530,-4.53216374269006
وصنعت,2021-01-13,175770990670,3516,1041,6,1458,3,23019032,3378882,25652331,745583,153875692510,21895298160,170746083620,5024907050,6850,6300,6360,6620,26397914,6660,1.99081163859112
وصنعت,2021-01-16,125422233680,1889,640,5,902,0,10072503,9690000,19762503,0,64061133680,61361100000,125422233680,0,6600,6330,6530,6330,19762503,6350,-4.65465465465466
وصنعت,2021-01-18,111505760000,1685,530,3,829,1,8846604,9600000,18444022,2582,53516560000,57989200000,111490164720,15595280,6180,6040,6100,6040,18446604,6040,-4.88188976377953
وصنعت,2021-01-19,136975114520,2321,727,4,1061,7,16828124,5136528,18461180,3503472,104559009630,32416104890,114995389210,21979725310,6340,5760,5780,6340,21964652,6240,3.3112582781457
وصنعت,2021-01-20,91125816860,1041,417,1,438,1,13914747,9200,11323947,2600000,91065556860,60260000,74099740360,17026076500,6550,6350,6550,6550,13923947,6540,4.80769230769231
وصنعت,2021-01-23,203995511650,3089,1444,1,817,2,29794049,767,27897283,1897533,203990265370,5246280,190985826470,13009685180,6860,6630,6860,6860,29794816,6850,4.74006116207951
وصنعت,2021-01-24,169227338950,3333,1391,4,992,1,22957648,2591536,25419184,130000,152261839590,16965499360,168356338950,871000000,7080,6510,7050,6510,25549184,6620,-3.35766423357664
وصنعت,2021-01-25,128617927260,2495,916,2,955,1,20039315,227171,20226986,39500,127188784670,1429142590,128362362260,255565000,6550,6290,6300,6300,20266486,6350,-4.0785498489426
وصنعت,2021-01-26,114259409130,2086,821,3,763,2,15321609,3397544,18569153,150000,93704871980,20554537150,113320216260,939192870,6560,6040,6200,6040,18719153,6100,-3.93700787401575
وصنعت,2021-01-27,61237434920,1498,528,4,670,2,9650039,468037,9728062,390014,58432459050,2804975870,58849249660,2388185260,6190,5900,6140,6150,10118076,6050,-0.819672131147541
وصنعت,2021-01-30,103983197860,1993,781,2,730,1,16403797,70000,16463797,10000,103541797860,441400000,103919697860,63500000,6350,6110,6110,6350,16473797,6310,4.29752066115703
وصنعت,2021-01-31,94969250660,2174,875,4,654,1,14948775,422858,15108987,262646,92368990470,2600260190,93308398380,1660852280,6500,6000,6350,6070,15371633,6180,-2.06022187004754
وصنعت,2021-02-01,199465694390,3730,1059,3,1448,5,31411535,223001,28368830,3265706,198099694790,1365999600,178969586210,20496108180,6480,6020,6050,6410,31634536,6310,2.10355987055016
وصنعت,2021-02-02,264015805550,3051,715,0,1453,6,40137387,0,36078440,4058947,264015805550,0,237205688320,26810117230,6620,6340,6520,6620,40137387,6580,4.27892234548336
وصنعت,2021-02-03,237612691840,2671,916,3,1017,1,34959541,2270834,36935075,295300,223318344760,14294347080,235687559840,1925132000,6730,6260,6600,6420,37230375,6380,-3.03951367781155
وصنعت,2021-02-06,138204004760,2024,655,2,959,2,21671911,810000,22028572,453339,133252404760,4951600000,135386802960,2817201800,6380,6070,6210,6140,22481911,6150,-3.60501567398119
وصنعت,2021-02-07,62574334310,1017,243,1,588,3,9624903,100000,8367713,1357190,61929334310,645000000,53833025310,8741309000,6450,6100,6100,6450,9724903,6430,4.55284552845528
وصنعت,2021-02-08,143220350470,2248,704,1,883,2,21965669,268189,20758374,1475484,141518464650,1701885820,133681335660,9539014810,6700,6110,6700,6500,22233858,6440,0.15552099533437
وصنعت,2021-02-09,212941054560,2125,509,0,1053,5,31904650,0,27341750,4562900,212941054560,0,182143750560,30797304000,6760,6350,6400,6760,31904650,6670,3.57142857142857
وصنعت,2021-02-13,238455289770,1950,761,2,737,7,33647503,94000,13641503,20100000,237790709770,664580000,96358689770,142096600000,7070,6820,7040,7070,33741503,7070,5.99700149925037
وصنعت,2021-02-14,243887072030,3572,1156,3,1460,3,33825347,591500,33202061,1214786,239748457030,4138615000,235273905190,8613166840,7360,6930,7280,7350,34416847,7090,0.282885431400283
وصنعت,2021-02-15,304738414300,2653,681,1,1422,8,40538933,39500,27452633,13125800,304441769300,296645000,206163656300,98574758000,7510,7450,7510,7510,40578433,7510,5.92383638928068
وصنعت,2021-02-16,261105297420,4079,1639,4,1339,3,31537459,3509000,34346990,699469,235173221870,25932075550,255957205580,5148091840,7770,7360,7650,7400,35046459,7450,-0.798934753661784
وصنعت,2021-02-17,252519772020,5122,2058,3,1521,4,33298867,497333,33022907,773293,248860645150,3659126870,246645384880,5874387140,7740,7310,7600,7350,33796200,7470,0.268456375838926
وصنعت,2021-02-20,257592966800,4660,1595,1,2020,4,33359640,780000,33083753,1055887,251875566800,5717400000,249546710690,8046256110,7800,7330,7330,7640,34139640,7550,1.07095046854083
وصنعت,2021-02-21,148302871350,2470,972,2,984,0,17328056,2605000,19933056,0,129021971350,19280900000,148302871350,0,7750,7400,7550,7400,19933056,7440,-1.45695364238411
وصنعت,2021-02-22,355999449570,6860,2082,2,2534,7,46785617,540000,37159208,10166409,351966849570,4032600000,280094171270,75905278300,7730,7300,7320,7460,47325617,7520,1.0752688172043
وصنعت,2021-02-23,245781923690,4381,1381,4,1786,7,31955747,917694,31551715,1321726,238998818910,6783104780,235833567490,9948356200,7700,7370,7550,7550,32873441,7480,-0.531914893617021
وصنعت,2021-02-24,152849586590,3148,1121,2,1304,2,18215204,2358000,20312804,260400,135498537470,17351049120,150865418590,1984168000,7700,7340,7700,7340,20573204,7430,-0.668449197860963
وصنعت,2021-02-27,36111723670,343,139,1,162,0,2353334,2600000,4953334,0,17157723670,18954000000,36111723670,0,7340,7290,7290,7290,4953334,7330,-1.34589502018843
وصنعت,2021-02-28,6337841200,63,43,1,12,0,361480,520000,881480,0,2599041200,3738800000,6337841200,0,7190,7190,7190,7190,881480,7310,-0.272851296043656
وصنعت,2021-03-01,16148252490,131,83,1,30,0,1212197,1040000,2252197,0,8691452490,7456800000,16148252490,0,7170,7170,7170,7170,2252197,7260,-0.683994528043776
وصنعت,2021-03-02,52587115610,1063,479,1,455,1,7230763,130000,7292912,67851,51661515610,925600000,52089767780,497347830,7330,7120,7120,7120,7360763,7140,-1.65289256198347
وصنعت,2021-03-03,17550252720,316,169,1,120,0,2503489,1000,2504489,0,17543252720,7000000,17550252720,0,7100,7000,7000,7000,2504489,7090,-0.700280112044818
وصنعت,2021-03-06,1199757650,62,59,0,2,0,172627,0,172627,0,1199757650,0,1199757650,0,6950,6950,6950,6950,172627,7090,0
وصنعت,2021-03-07,5830862350,146,120,0,10,0,838973,0,838973,0,5830862350,0,5830862350,0,6950,6950,6950,6950,838973,7070,-0.282087447108604
وصنعت,2021-03-08,13216341600,282,182,0,44,1,1907120,0,1904922,2198,13216341600,0,13201109460,15232140,6930,6930,6930,6930,1907120,7030,-0.565770862800566
وصنعت,2021-03-09,90048511610,1886,788,4,691,1,11394968,1602565,12867533,130000,78977060180,11071451430,89126811610,921700000,7180,6890,6890,6890,12997533,6930,-1.42247510668563
وصنعت,2021-03-10,13560315200,286,125,3,136,0,549464,1444700,1994164,0,3736355200,9823960000,13560315200,0,6800,6800,6800,6800,1994164,6890,-0.577200577200577
وصنعت,2021-03-13,22793340960,367,233,2,68,1,1806796,1565000,3221796,150000,12213940960,10579400000,21779340960,1014000000,6760,6760,6760,6760,3371796,6830,-0.870827285921625
